filename,frame_num,bb1,bb2,bb3,bb4,track,track_temp,Height
IMG_3326.MOV,1,1312,572,1461,905,1,0,333
IMG_3326.MOV,2,1313,572,1463,905,1,0,333
IMG_3326.MOV,3,1315,571,1465,905,1,0,334
IMG_3326.MOV,4,1316,571,1467,904,1,0,333
IMG_3326.MOV,5,1329,564,1486,909,1,0,345
IMG_3326.MOV,6,1333,561,1491,910,1,0,349
IMG_3326.MOV,7,1335,561,1494,912,1,0,351
IMG_3326.MOV,8,1339,562,1499,915,1,0,353
IMG_3326.MOV,9,1338,562,1498,917,1,0,355
IMG_3326.MOV,10,1335,561,1495,918,1,0,357
IMG_3326.MOV,11,1334,560,1496,923,1,0,363
IMG_3326.MOV,12,1334,559,1497,926,1,0,367
IMG_3326.MOV,13,1335,559,1497,927,1,0,368
IMG_3326.MOV,14,1336,560,1497,928,1,0,368
IMG_3326.MOV,15,1336,560,1496,929,1,0,369
IMG_3326.MOV,16,1337,559,1497,927,1,0,368
IMG_3326.MOV,17,1339,557,1499,929,1,0,372
IMG_3326.MOV,18,1340,559,1499,930,1,0,371
IMG_3326.MOV,19,1340,561,1499,931,1,0,370
IMG_3326.MOV,20,1342,561,1500,930,1,0,369
IMG_3326.MOV,21,1343,562,1501,931,1,0,369
IMG_3326.MOV,22,1344,563,1503,931,1,0,368
IMG_3326.MOV,23,1345,563,1504,931,1,0,368
IMG_3326.MOV,24,1345,564,1505,931,1,0,367
IMG_3326.MOV,25,1346,562,1508,932,1,0,370
IMG_3326.MOV,26,1346,560,1510,932,1,0,372
IMG_3326.MOV,27,1348,559,1512,933,1,0,374
IMG_3326.MOV,28,1351,560,1515,931,1,0,371
IMG_3326.MOV,29,1353,559,1517,931,1,0,372
IMG_3326.MOV,30,1356,558,1521,931,1,0,373
IMG_3326.MOV,31,1362,558,1525,931,1,0,373
IMG_3326.MOV,32,1363,558,1528,935,1,0,377
IMG_3326.MOV,33,1363,558,1530,938,1,0,380
IMG_3326.MOV,34,1368,561,1532,935,1,0,374
IMG_3326.MOV,35,1371,564,1534,933,1,0,369
IMG_3326.MOV,36,1375,567,1535,930,1,0,363
IMG_3326.MOV,37,1378,568,1537,929,1,0,361
IMG_3326.MOV,38,1381,569,1539,929,1,0,360
IMG_3326.MOV,39,1385,568,1541,927,1,0,359
IMG_3326.MOV,40,1383,567,1544,935,1,0,368
IMG_3326.MOV,41,1385,565,1547,939,1,0,374
IMG_3326.MOV,42,1384,569,1549,953,1,0,384
IMG_3326.MOV,43,1386,563,1550,947,1,0,384
IMG_3326.MOV,44,1398,563,1558,943,1,0,380
IMG_3326.MOV,45,1405,562,1562,944,1,0,382
IMG_3326.MOV,46,1406,568,1565,956,1,0,388
IMG_3326.MOV,47,1409,571,1566,960,1,0,389
IMG_3326.MOV,48,1412,572,1568,964,1,0,392
IMG_3326.MOV,49,1415,574,1568,962,1,0,388
IMG_3326.MOV,50,1416,576,1567,963,1,0,387
IMG_3326.MOV,51,1420,572,1564,945,1,0,373
IMG_3326.MOV,52,1420,577,1566,960,1,0,383
IMG_3326.MOV,53,1423,577,1568,961,1,0,384
IMG_3326.MOV,54,1427,571,1567,945,1,0,374
IMG_3326.MOV,55,1431,571,1567,936,1,0,365
IMG_3326.MOV,56,1433,572,1568,933,1,0,361
IMG_3326.MOV,57,1433,580,1569,943,1,0,363
IMG_3326.MOV,58,1433,582,1571,950,1,0,368
IMG_3326.MOV,59,1433,582,1572,953,1,0,371
IMG_3326.MOV,60,1433,582,1574,955,1,0,373
IMG_3326.MOV,61,1436,583,1576,955,1,0,372
IMG_3326.MOV,62,1436,584,1576,952,1,0,368
IMG_3326.MOV,63,1437,584,1579,955,1,0,371
IMG_3326.MOV,64,1437,583,1580,957,1,0,374
IMG_3326.MOV,65,1438,584,1582,958,1,0,374
IMG_3326.MOV,66,1438,584,1582,957,1,0,373
IMG_3326.MOV,67,1439,586,1583,958,1,0,372
IMG_3326.MOV,68,1440,588,1583,957,1,0,369
IMG_3326.MOV,69,1440,589,1584,957,1,0,368
IMG_3326.MOV,70,1440,589,1585,957,1,0,368
IMG_3326.MOV,71,1447,587,1592,958,1,0,371
IMG_3326.MOV,72,1449,588,1595,960,1,0,372
IMG_3326.MOV,73,1451,588,1597,960,1,0,372
IMG_3326.MOV,74,1452,591,1597,961,1,0,370
IMG_3326.MOV,75,1451,593,1596,962,1,0,369
IMG_3326.MOV,76,1451,592,1597,961,1,0,369
IMG_3326.MOV,77,1452,591,1598,959,1,0,368
IMG_3326.MOV,78,1454,589,1600,959,1,0,370
IMG_3326.MOV,79,1456,588,1603,958,1,0,370
IMG_3326.MOV,80,1458,587,1605,959,1,0,372
IMG_3326.MOV,81,1459,589,1605,959,1,0,370
IMG_3326.MOV,82,1458,588,1606,961,1,0,373
IMG_3326.MOV,83,1460,587,1610,963,1,0,376
IMG_3326.MOV,84,1461,588,1611,963,1,0,375
IMG_3326.MOV,85,1459,589,1610,963,1,0,374
IMG_3326.MOV,86,1459,591,1611,962,1,0,371
IMG_3326.MOV,87,1460,593,1613,963,1,0,370
IMG_3326.MOV,88,1462,595,1615,963,1,0,368
IMG_3326.MOV,89,1461,588,1618,966,1,0,378
IMG_3326.MOV,90,1475,593,1627,960,1,0,367
IMG_3326.MOV,91,1481,595,1632,958,1,0,363
IMG_3326.MOV,92,1483,595,1635,960,1,0,365
IMG_3326.MOV,93,1484,593,1636,960,1,0,367
IMG_3326.MOV,94,1485,593,1637,961,1,0,368
IMG_3326.MOV,95,1485,592,1637,962,1,0,370
IMG_3326.MOV,96,1486,591,1639,963,1,0,372
IMG_3326.MOV,97,1488,589,1641,964,1,0,375
IMG_3326.MOV,98,1487,585,1643,969,1,0,384
IMG_3326.MOV,99,1486,583,1643,973,1,0,390
IMG_3326.MOV,100,1487,583,1643,973,1,0,390
IMG_3326.MOV,101,1487,584,1642,974,1,0,390
IMG_3326.MOV,102,1487,583,1642,975,1,0,392
IMG_3326.MOV,103,1488,583,1642,975,1,0,392
IMG_3326.MOV,104,1489,584,1642,975,1,0,391
IMG_3326.MOV,105,1490,584,1642,975,1,0,391
IMG_3326.MOV,106,1491,583,1642,972,1,0,389
IMG_3326.MOV,107,1492,584,1641,971,1,0,387
IMG_3326.MOV,108,1491,587,1638,968,1,0,381
IMG_3326.MOV,109,1491,589,1637,966,1,0,377
IMG_3326.MOV,110,1493,587,1638,964,1,0,377
IMG_3326.MOV,111,1494,587,1639,965,1,0,378
IMG_3326.MOV,112,1498,589,1642,969,1,0,380
IMG_3326.MOV,113,1499,587,1645,977,1,0,390
IMG_3326.MOV,114,1499,588,1645,982,1,0,394
IMG_3326.MOV,115,1499,590,1647,989,1,0,399
IMG_3326.MOV,116,1504,590,1651,992,1,0,402
IMG_3326.MOV,117,1508,593,1654,992,1,0,399
IMG_3326.MOV,118,1511,595,1656,993,1,0,398
IMG_3326.MOV,119,1515,600,1655,987,1,0,387
IMG_3326.MOV,120,1515,601,1656,990,1,0,389
IMG_3326.MOV,121,1514,600,1656,990,1,0,390
IMG_3326.MOV,122,1516,599,1659,992,1,0,393
IMG_3326.MOV,123,1519,599,1663,994,1,0,395
IMG_3326.MOV,124,1521,599,1665,992,1,0,393
IMG_3326.MOV,125,1522,598,1667,993,1,0,395
IMG_3326.MOV,126,1525,597,1672,995,1,0,398
IMG_3326.MOV,127,1525,596,1673,993,1,0,397
IMG_3326.MOV,128,1524,594,1672,993,1,0,399
IMG_3326.MOV,129,1525,593,1676,997,1,0,404
IMG_3326.MOV,130,1526,593,1679,999,1,0,406
IMG_3326.MOV,131,1524,593,1676,994,1,0,401
IMG_3326.MOV,132,1524,593,1678,995,1,0,402
IMG_3326.MOV,133,1526,593,1681,995,1,0,402
IMG_3326.MOV,134,1526,595,1680,991,1,0,396
IMG_3326.MOV,135,1526,597,1679,987,1,0,390
IMG_3326.MOV,136,1525,598,1679,986,1,0,388
IMG_3326.MOV,137,1527,598,1680,984,1,0,386
IMG_3326.MOV,138,1527,599,1679,984,1,0,385
IMG_3326.MOV,139,1528,601,1680,983,1,0,382
IMG_3326.MOV,140,1530,602,1681,984,1,0,382
IMG_3326.MOV,141,1530,604,1682,986,1,0,382
IMG_3326.MOV,142,1531,606,1683,988,1,0,382
IMG_3326.MOV,143,1531,607,1684,989,1,0,382
IMG_3326.MOV,144,1530,607,1684,991,1,0,384
IMG_3326.MOV,145,1530,608,1685,993,1,0,385
IMG_3326.MOV,146,1530,610,1686,995,1,0,385
IMG_3326.MOV,147,1530,610,1689,996,1,0,386
IMG_3326.MOV,148,1530,610,1689,995,1,0,385
IMG_3326.MOV,149,1528,607,1692,999,1,0,392
IMG_3326.MOV,150,1528,606,1695,1003,1,0,397
IMG_3326.MOV,151,1527,603,1698,1007,1,0,404
IMG_3326.MOV,152,1526,603,1700,1011,1,0,408
IMG_3326.MOV,153,1526,605,1701,1010,1,0,405
IMG_3326.MOV,154,1525,606,1702,1010,1,0,404
IMG_3326.MOV,155,1525,606,1704,1009,1,0,403
IMG_3326.MOV,156,1537,607,1717,1005,1,0,398
IMG_3326.MOV,157,1540,606,1723,1004,1,0,398
IMG_3326.MOV,158,1541,605,1726,1005,1,0,400
IMG_3326.MOV,159,1542,604,1730,1004,1,0,400
IMG_3326.MOV,160,1542,604,1731,1004,1,0,400
IMG_3326.MOV,161,1543,604,1734,1003,1,0,399
IMG_3326.MOV,162,1545,603,1737,1003,1,0,400
IMG_3326.MOV,163,1547,601,1743,1007,1,0,406
IMG_3326.MOV,164,1546,600,1745,1010,1,0,410
IMG_3326.MOV,165,1549,597,1751,1014,1,0,417
IMG_3326.MOV,166,1553,597,1756,1016,1,0,419
IMG_3326.MOV,167,1557,597,1758,1014,1,0,417
IMG_3326.MOV,168,1563,597,1762,1014,1,0,417
IMG_3326.MOV,169,1567,598,1763,1013,1,0,415
IMG_3326.MOV,170,1571,597,1765,1011,1,0,414
IMG_3326.MOV,171,1573,596,1765,1009,1,0,413
IMG_3326.MOV,172,1576,595,1767,1010,1,0,415
IMG_3326.MOV,173,1578,594,1768,1010,1,0,416
IMG_3326.MOV,174,1582,592,1771,1009,1,0,417
IMG_3326.MOV,175,1583,592,1771,1012,1,0,420
IMG_3326.MOV,176,1585,592,1771,1012,1,0,420
IMG_3326.MOV,177,1589,593,1772,1011,1,0,418
IMG_3326.MOV,178,1594,593,1773,1008,1,0,415
IMG_3326.MOV,179,1597,593,1772,1006,1,0,413
IMG_3326.MOV,180,1599,592,1774,1009,1,0,417
IMG_3326.MOV,181,1603,592,1774,1007,1,0,415
IMG_3326.MOV,182,1604,591,1774,1007,1,0,416
IMG_3326.MOV,183,1614,594,1784,1014,1,0,420
IMG_3326.MOV,184,1619,596,1788,1018,1,0,422
IMG_3326.MOV,185,1621,596,1791,1024,1,0,428
IMG_3326.MOV,186,1620,595,1792,1033,1,0,438
IMG_3326.MOV,187,1623,597,1792,1031,1,0,434
IMG_3326.MOV,188,1624,598,1791,1030,1,0,432
IMG_3326.MOV,189,1624,596,1792,1034,1,0,438
IMG_3326.MOV,190,1624,595,1793,1036,1,0,441
IMG_3326.MOV,191,1626,597,1792,1035,1,0,438
IMG_3326.MOV,192,1627,597,1792,1036,1,0,439
IMG_3326.MOV,193,1629,597,1794,1037,1,0,440
IMG_3326.MOV,194,1630,597,1795,1038,1,0,441
IMG_3326.MOV,195,1630,596,1796,1040,1,0,444
IMG_3326.MOV,196,1630,596,1796,1038,1,0,442
IMG_3326.MOV,197,1632,600,1794,1029,1,0,429
IMG_3326.MOV,198,1634,600,1796,1029,1,0,429
IMG_3326.MOV,199,1635,600,1797,1029,1,0,429
IMG_3326.MOV,200,1635,601,1797,1028,1,0,427
IMG_3326.MOV,201,1637,602,1798,1028,1,0,426
IMG_3326.MOV,202,1640,603,1798,1022,1,0,419
IMG_3326.MOV,203,1641,602,1797,1019,1,0,417
IMG_3326.MOV,204,1641,601,1798,1020,1,0,419
IMG_3326.MOV,205,1640,600,1797,1022,1,0,422
IMG_3326.MOV,206,1639,600,1796,1025,1,0,425
IMG_3326.MOV,207,1637,598,1795,1031,1,0,433
IMG_3326.MOV,208,1637,596,1795,1033,1,0,437
IMG_3326.MOV,209,1638,595,1795,1034,1,0,439
IMG_3326.MOV,210,1638,593,1795,1035,1,0,442
IMG_3326.MOV,211,1638,591,1794,1037,1,0,446
IMG_3326.MOV,212,1639,591,1794,1038,1,0,447
IMG_3326.MOV,213,1642,591,1795,1036,1,0,445
IMG_3326.MOV,214,1644,592,1796,1034,1,0,442
IMG_3326.MOV,215,1646,591,1797,1032,1,0,441
IMG_3326.MOV,216,1646,591,1798,1033,1,0,442
IMG_3326.MOV,217,1646,591,1797,1033,1,0,442
IMG_3326.MOV,218,1645,591,1796,1033,1,0,442
IMG_3326.MOV,219,1645,591,1795,1033,1,0,442
IMG_3326.MOV,220,1646,590,1796,1035,1,0,445
IMG_3326.MOV,221,1646,590,1795,1035,1,0,445
IMG_3326.MOV,222,1646,590,1795,1034,1,0,444
IMG_3326.MOV,223,1646,590,1794,1033,1,0,443
IMG_3326.MOV,224,1646,591,1793,1033,1,0,442
IMG_3326.MOV,225,1647,593,1793,1032,1,0,439
IMG_3326.MOV,226,1647,595,1792,1032,1,0,437
IMG_3326.MOV,227,1646,595,1791,1031,1,0,436
IMG_3326.MOV,228,1646,596,1791,1032,1,0,436
IMG_3326.MOV,229,1646,597,1791,1032,1,0,435
IMG_3326.MOV,230,1646,596,1790,1032,1,0,436
IMG_3326.MOV,231,1646,596,1790,1031,1,0,435
IMG_3326.MOV,232,1646,596,1790,1031,1,0,435
IMG_3326.MOV,233,1647,595,1791,1031,1,0,436
IMG_3326.MOV,234,1647,595,1791,1032,1,0,437
IMG_3326.MOV,235,1647,596,1791,1032,1,0,436
IMG_3326.MOV,236,1647,596,1790,1030,1,0,434
IMG_3326.MOV,237,1647,597,1790,1029,1,0,432
IMG_3326.MOV,238,1647,597,1789,1029,1,0,432
IMG_3326.MOV,239,1647,599,1789,1026,1,0,427
IMG_3326.MOV,240,1648,599,1789,1027,1,0,428
IMG_3326.MOV,241,1647,599,1789,1028,1,0,429
IMG_3326.MOV,242,1648,600,1790,1028,1,0,428
IMG_3326.MOV,243,1648,600,1790,1028,1,0,428
IMG_3326.MOV,244,1647,600,1790,1029,1,0,429
IMG_3326.MOV,245,1647,600,1790,1031,1,0,431
IMG_3326.MOV,246,1647,600,1790,1031,1,0,431
IMG_3326.MOV,247,1647,600,1790,1031,1,0,431
IMG_3326.MOV,248,1647,600,1790,1031,1,0,431
IMG_3326.MOV,249,1648,600,1791,1032,1,0,432
IMG_3326.MOV,250,1648,600,1791,1033,1,0,433
IMG_3326.MOV,251,1648,600,1791,1033,1,0,433
IMG_3326.MOV,252,1647,600,1791,1034,1,0,434
IMG_3326.MOV,253,1648,600,1791,1035,1,0,435
IMG_3326.MOV,254,1648,600,1791,1034,1,0,434
IMG_3326.MOV,255,1648,600,1791,1034,1,0,434
IMG_3326.MOV,256,1648,600,1790,1034,1,0,434
IMG_3326.MOV,257,1649,600,1791,1034,1,0,434
IMG_3326.MOV,258,1649,599,1791,1034,1,0,435
IMG_3326.MOV,259,1649,599,1791,1036,1,0,437
IMG_3326.MOV,260,1649,598,1790,1036,1,0,438
IMG_3326.MOV,261,1648,598,1790,1036,1,0,438
IMG_3326.MOV,262,1649,598,1789,1036,1,0,438
IMG_3326.MOV,263,1649,598,1789,1036,1,0,438
IMG_3326.MOV,264,1649,598,1788,1036,1,0,438
IMG_3326.MOV,265,1648,598,1788,1036,1,0,438
IMG_3326.MOV,266,1649,598,1788,1035,1,0,437
IMG_3326.MOV,267,1649,598,1787,1035,1,0,437
IMG_3326.MOV,268,1649,598,1787,1035,1,0,437
IMG_3326.MOV,269,1649,598,1786,1034,1,0,436
IMG_3326.MOV,270,1650,598,1786,1032,1,0,434
IMG_3326.MOV,271,1651,599,1786,1032,1,0,433
IMG_3326.MOV,272,1651,600,1786,1031,1,0,431
IMG_3326.MOV,273,1652,600,1786,1030,1,0,430
IMG_3326.MOV,274,1652,601,1786,1030,1,0,429
IMG_3326.MOV,275,1652,601,1786,1030,1,0,429
IMG_3326.MOV,276,1653,601,1787,1031,1,0,430
IMG_3326.MOV,277,1653,600,1787,1031,1,0,431
IMG_3326.MOV,278,1653,600,1787,1031,1,0,431
IMG_3326.MOV,279,1653,600,1787,1033,1,0,433
IMG_3326.MOV,280,1653,599,1787,1033,1,0,434
IMG_3326.MOV,281,1652,599,1787,1033,1,0,434
IMG_3326.MOV,282,1652,599,1786,1032,1,0,433
IMG_3326.MOV,283,1651,599,1786,1032,1,0,433
IMG_3326.MOV,284,1651,599,1786,1032,1,0,433
IMG_3326.MOV,285,1650,599,1785,1031,1,0,432
IMG_3326.MOV,286,1650,599,1785,1031,1,0,432
IMG_3326.MOV,287,1650,599,1784,1031,1,0,432
IMG_3326.MOV,288,1650,599,1784,1031,1,0,432
IMG_3326.MOV,289,1650,599,1784,1031,1,0,432
IMG_3326.MOV,290,1650,599,1784,1031,1,0,432
IMG_3326.MOV,291,1651,599,1785,1031,1,0,432
IMG_3326.MOV,292,1651,600,1785,1030,1,0,430
IMG_3326.MOV,293,1652,600,1785,1028,1,0,428
IMG_3326.MOV,294,1651,600,1784,1027,1,0,427
IMG_3326.MOV,295,1650,601,1785,1028,1,0,427
IMG_3326.MOV,296,1650,601,1784,1028,1,0,427
IMG_3326.MOV,297,1651,602,1786,1030,1,0,428
IMG_3326.MOV,298,1650,601,1787,1032,1,0,431
IMG_3326.MOV,299,1651,603,1787,1031,1,0,428
IMG_3326.MOV,300,1652,603,1787,1029,1,0,426
IMG_3326.MOV,301,1653,604,1787,1028,1,0,424
IMG_3326.MOV,302,1652,604,1787,1029,1,0,425
IMG_3326.MOV,303,1652,602,1788,1032,1,0,430
IMG_3326.MOV,304,1652,600,1790,1034,1,0,434
IMG_3326.MOV,305,1652,600,1790,1036,1,0,436
IMG_3326.MOV,306,1652,601,1790,1037,1,0,436
IMG_3326.MOV,307,1651,601,1790,1038,1,0,437
IMG_3326.MOV,308,1652,602,1790,1039,1,0,437
IMG_3326.MOV,309,1652,602,1790,1039,1,0,437
IMG_3326.MOV,310,1653,602,1790,1039,1,0,437
IMG_3326.MOV,311,1654,602,1792,1039,1,0,437
IMG_3326.MOV,312,1655,600,1793,1040,1,0,440
IMG_3326.MOV,313,1656,600,1793,1039,1,0,439
IMG_3326.MOV,314,1656,600,1793,1037,1,0,437
IMG_3326.MOV,315,1656,600,1792,1035,1,0,435
IMG_3326.MOV,316,1655,600,1792,1035,1,0,435
IMG_3326.MOV,317,1656,599,1792,1035,1,0,436
IMG_3326.MOV,318,1655,597,1793,1037,1,0,440
IMG_3326.MOV,319,1655,596,1793,1037,1,0,441
IMG_3326.MOV,320,1654,596,1793,1038,1,0,442
IMG_3326.MOV,321,1654,597,1793,1037,1,0,440
IMG_3326.MOV,322,1653,596,1793,1039,1,0,443
IMG_3326.MOV,323,1649,595,1790,1039,1,0,444
IMG_3326.MOV,324,1647,598,1788,1037,1,0,439
IMG_3326.MOV,325,1647,598,1789,1039,1,0,441
IMG_3326.MOV,326,1646,599,1788,1037,1,0,438
IMG_3326.MOV,327,1645,599,1789,1039,1,0,440
IMG_3326.MOV,328,1645,598,1790,1038,1,0,440
IMG_3326.MOV,329,1644,598,1791,1037,1,0,439
IMG_3326.MOV,330,1644,596,1792,1037,1,0,441
IMG_3326.MOV,331,1643,594,1793,1037,1,0,443
IMG_3326.MOV,332,1641,593,1793,1038,1,0,445
IMG_3326.MOV,333,1640,593,1793,1038,1,0,445
IMG_3326.MOV,334,1641,595,1793,1036,1,0,441
IMG_3326.MOV,335,1643,595,1795,1036,1,0,441
IMG_3326.MOV,336,1648,597,1799,1034,1,0,437
IMG_3326.MOV,337,1652,597,1803,1034,1,0,437
IMG_3326.MOV,338,1654,595,1806,1035,1,0,440
IMG_3326.MOV,339,1656,594,1808,1033,1,0,439
IMG_3326.MOV,340,1655,592,1808,1033,1,0,441
IMG_3326.MOV,341,1657,590,1811,1036,1,0,446
IMG_3326.MOV,342,1658,591,1812,1034,1,0,443
IMG_3326.MOV,343,1660,592,1813,1032,1,0,440
IMG_3326.MOV,344,1659,593,1811,1031,1,0,438
IMG_3326.MOV,345,1654,590,1809,1035,1,0,445
IMG_3326.MOV,346,1654,591,1809,1037,1,0,446
IMG_3326.MOV,347,1655,592,1809,1035,1,0,443
IMG_3326.MOV,348,1657,593,1810,1037,1,0,444
IMG_3326.MOV,349,1658,594,1812,1037,1,0,443
IMG_3326.MOV,350,1660,594,1814,1036,1,0,442
IMG_3326.MOV,351,1659,592,1814,1036,1,0,444
IMG_3326.MOV,352,1659,591,1814,1036,1,0,445
IMG_3326.MOV,353,1660,590,1815,1035,1,0,445
IMG_3326.MOV,354,1661,591,1816,1035,1,0,444
IMG_3326.MOV,355,1662,592,1817,1035,1,0,443
IMG_3326.MOV,356,1662,592,1818,1034,1,0,442
IMG_3326.MOV,357,1662,590,1819,1035,1,0,445
IMG_3326.MOV,358,1660,587,1819,1037,1,0,450
IMG_3326.MOV,359,1659,590,1817,1037,1,0,447
IMG_3326.MOV,360,1660,596,1817,1037,1,0,441
IMG_3326.MOV,361,1660,599,1816,1037,1,0,438
IMG_3326.MOV,362,1661,600,1817,1036,1,0,436
IMG_3326.MOV,363,1662,600,1818,1036,1,0,436
IMG_3326.MOV,364,1663,602,1818,1036,1,0,434
IMG_3326.MOV,365,1665,604,1819,1036,1,0,432
IMG_3326.MOV,366,1666,603,1821,1035,1,0,432
IMG_3326.MOV,367,1667,603,1821,1035,1,0,432
IMG_3326.MOV,368,1667,602,1823,1037,1,0,435
IMG_3326.MOV,369,1667,603,1822,1036,1,0,433
IMG_3326.MOV,370,1666,603,1821,1037,1,0,434
IMG_3326.MOV,371,1666,601,1822,1042,1,0,441
IMG_3326.MOV,372,1664,599,1821,1042,1,0,443
IMG_3326.MOV,373,1665,598,1822,1043,1,0,445
IMG_3326.MOV,374,1665,598,1822,1043,1,0,445
IMG_3326.MOV,375,1666,598,1823,1043,1,0,445
IMG_3326.MOV,376,1668,599,1824,1043,1,0,444
IMG_3326.MOV,377,1670,599,1826,1042,1,0,443
IMG_3326.MOV,378,1671,599,1827,1041,1,0,442
IMG_3326.MOV,379,1674,598,1830,1040,1,0,442
IMG_3326.MOV,380,1676,598,1832,1040,1,0,442
IMG_3326.MOV,381,1676,597,1833,1042,1,0,445
IMG_3326.MOV,382,1677,597,1835,1040,1,0,443
IMG_3326.MOV,383,1679,595,1837,1037,1,0,442
IMG_3326.MOV,384,1680,595,1839,1038,1,0,443
IMG_3326.MOV,385,1681,597,1841,1040,1,0,443
IMG_3326.MOV,386,1681,597,1843,1043,1,0,446
IMG_3326.MOV,387,1680,593,1846,1051,1,0,458
IMG_3326.MOV,388,1679,591,1848,1057,1,0,466
IMG_3326.MOV,389,1689,594,1859,1056,1,0,462
IMG_3326.MOV,390,1691,590,1864,1061,1,0,471
IMG_3326.MOV,391,1694,592,1866,1058,1,0,466
IMG_3326.MOV,392,1693,590,1868,1062,1,0,472
IMG_3326.MOV,393,1695,599,1872,1072,1,0,473
IMG_3326.MOV,394,1698,603,1879,1077,1,0,474
IMG_3326.MOV,395,1701,606,1883,1078,1,0,472
IMG_3326.MOV,396,1702,607,1889,1080,1,0,473
IMG_3326.MOV,397,1704,608,1893,1081,1,0,473
IMG_3326.MOV,398,1704,609,1895,1081,1,0,472
IMG_3326.MOV,399,1703,609,1896,1078,1,0,469
IMG_3326.MOV,400,1703,610,1897,1076,1,0,466
IMG_3326.MOV,401,1702,610,1898,1075,1,0,465
IMG_3326.MOV,402,1703,614,1901,1074,1,0,460
IMG_3326.MOV,403,1704,616,1902,1072,1,0,456
IMG_3326.MOV,404,1701,613,1903,1072,1,0,459
IMG_3326.MOV,405,1699,611,1902,1069,1,0,458
IMG_3326.MOV,406,1699,614,1904,1069,1,0,455
IMG_3326.MOV,407,1698,612,1907,1071,1,0,459
IMG_3326.MOV,408,1698,610,1909,1071,1,0,461
IMG_3326.MOV,409,1697,608,1911,1070,1,0,462
IMG_3326.MOV,410,1697,606,1912,1070,1,0,464
IMG_3326.MOV,411,1699,606,1914,1069,1,0,463
IMG_3326.MOV,412,1701,608,1916,1069,1,0,461
IMG_3326.MOV,413,1704,612,1917,1069,1,0,457
IMG_3326.MOV,414,1706,613,1920,1071,1,0,458
IMG_3326.MOV,415,1709,612,1922,1071,1,0,459
IMG_3326.MOV,416,1709,614,1922,1072,1,0,458
IMG_3326.MOV,417,1710,615,1922,1071,1,0,456
IMG_3326.MOV,418,1712,614,1923,1069,1,0,455
IMG_3326.MOV,419,1713,614,1925,1072,1,0,458
IMG_3326.MOV,420,1714,615,1926,1074,1,0,459
IMG_3326.MOV,421,1715,613,1928,1076,1,0,463
IMG_3326.MOV,422,1717,611,1930,1078,1,0,467
IMG_3326.MOV,423,1721,611,1933,1080,1,0,469
IMG_3326.MOV,424,1725,613,1933,1081,1,0,468
IMG_3326.MOV,425,1744,614,1945,1080,1,0,466
IMG_3326.MOV,426,1752,618,1948,1081,1,0,463
IMG_3326.MOV,427,1758,622,1946,1078,1,0,456
IMG_3326.MOV,428,1760,621,1946,1081,1,0,460
IMG_3326.MOV,429,1762,619,1945,1082,1,0,463
IMG_3326.MOV,430,1764,619,1943,1081,1,0,462
IMG_3326.MOV,431,1767,620,1943,1083,1,0,463
IMG_3326.MOV,432,1770,619,1942,1084,1,0,465
IMG_3326.MOV,433,1773,619,1941,1085,1,0,466
IMG_3326.MOV,434,1774,620,1940,1085,1,0,465
IMG_3326.MOV,435,1777,624,1938,1084,1,0,460
IMG_3326.MOV,436,1779,624,1937,1083,1,0,459
IMG_3326.MOV,437,1781,626,1935,1082,1,0,456
IMG_3326.MOV,438,1782,628,1934,1080,1,0,452
IMG_3326.MOV,439,1784,628,1933,1079,1,0,451
IMG_3326.MOV,440,1786,627,1934,1079,1,0,452
IMG_3326.MOV,441,1788,626,1935,1082,1,0,456
IMG_3326.MOV,442,1789,624,1934,1083,1,0,459
IMG_3326.MOV,443,1791,623,1934,1085,1,0,462
IMG_3326.MOV,444,1792,622,1934,1091,1,0,469
IMG_3326.MOV,445,1793,623,1932,1090,1,0,467
IMG_3326.MOV,446,1797,622,1933,1089,1,0,467
IMG_3326.MOV,447,1799,620,1934,1089,1,0,469
IMG_3326.MOV,448,1800,619,1932,1090,1,0,471
IMG_3326.MOV,449,1802,620,1933,1091,1,0,471
IMG_3326.MOV,450,1807,627,1933,1091,1,0,464
IMG_3326.MOV,451,1810,639,1931,1090,1,0,451
IMG_3326.MOV,452,1812,645,1930,1089,1,0,444
IMG_3326.MOV,453,1815,653,1928,1088,1,0,435
IMG_3326.MOV,454,1817,656,1928,1086,1,0,430
IMG_3326.MOV,455,1818,659,1927,1084,1,0,425
IMG_3326.MOV,456,1821,662,1927,1082,1,0,420
IMG_3326.MOV,457,1823,665,1928,1082,1,0,417
IMG_3326.MOV,458,1825,670,1927,1082,1,0,412
IMG_3326.MOV,459,1826,674,1926,1080,1,0,406
IMG_3326.MOV,460,1829,682,1925,1077,1,0,395
IMG_3326.MOV,461,1830,683,1925,1078,1,0,395
IMG_3326.MOV,462,1831,689,1924,1077,1,0,388
IMG_3326.MOV,463,1832,686,1925,1077,1,0,391
IMG_3326.MOV,464,1831,661,1928,1079,1,0,418
IMG_3326.MOV,465,1832,644,1931,1080,1,0,436
IMG_3326.MOV,466,1834,635,1932,1080,1,0,445
IMG_3326.MOV,467,1835,632,1933,1080,1,1,448
IMG_3326.MOV,1,1519,625,1644,870,2,0,245
IMG_3326.MOV,2,1521,625,1645,869,2,0,244
IMG_3326.MOV,3,1522,626,1646,869,2,0,243
IMG_3326.MOV,4,1523,626,1648,871,2,0,245
IMG_3326.MOV,5,1525,626,1650,871,2,0,245
IMG_3326.MOV,6,1527,629,1651,871,2,0,242
IMG_3326.MOV,7,1533,630,1655,869,2,0,239
IMG_3326.MOV,8,1536,629,1657,870,2,0,241
IMG_3326.MOV,9,1537,630,1658,872,2,0,242
IMG_3326.MOV,10,1540,631,1659,870,2,0,239
IMG_3326.MOV,11,1544,632,1661,868,2,0,236
IMG_3326.MOV,12,1548,632,1665,868,2,0,236
IMG_3326.MOV,13,1554,633,1669,867,2,0,234
IMG_3326.MOV,14,1557,631,1673,870,2,0,239
IMG_3326.MOV,15,1559,629,1675,872,2,0,243
IMG_3326.MOV,16,1570,631,1683,870,2,0,239
IMG_3326.MOV,17,1576,633,1687,867,2,0,234
IMG_3326.MOV,18,1579,632,1691,869,2,0,237
IMG_3326.MOV,19,1582,631,1694,871,2,0,240
IMG_3326.MOV,20,1581,636,1698,889,2,0,253
IMG_3326.MOV,21,1582,640,1699,895,2,0,255
IMG_3326.MOV,22,1582,643,1699,898,2,0,255
IMG_3326.MOV,23,1582,645,1700,901,2,0,256
IMG_3326.MOV,24,1584,647,1700,897,2,0,250
IMG_3326.MOV,25,1587,647,1700,893,2,0,246
IMG_3326.MOV,26,1590,645,1706,897,2,0,252
IMG_3326.MOV,27,1593,644,1711,900,2,0,256
IMG_3326.MOV,28,1595,644,1714,902,2,0,258
IMG_3326.MOV,29,1596,645,1716,907,2,0,262
IMG_3326.MOV,30,1599,649,1718,908,2,0,259
IMG_3326.MOV,31,1600,652,1718,908,2,0,256
IMG_3326.MOV,32,1602,655,1719,908,2,0,253
IMG_3326.MOV,33,1603,655,1722,909,2,0,254
IMG_3326.MOV,34,1606,656,1724,910,2,0,254
IMG_3326.MOV,35,1606,655,1725,910,2,0,255
IMG_3326.MOV,36,1606,654,1724,908,2,0,254
IMG_3326.MOV,37,1606,651,1727,911,2,0,260
IMG_3326.MOV,38,1607,650,1729,916,2,0,266
IMG_3326.MOV,39,1607,650,1731,921,2,0,271
IMG_3326.MOV,40,1609,652,1732,922,2,0,270
IMG_3326.MOV,41,1613,652,1733,920,2,0,268
IMG_3326.MOV,42,1618,653,1736,915,2,0,262
IMG_3326.MOV,43,1620,653,1737,915,2,0,262
IMG_3326.MOV,44,1623,654,1738,912,2,0,258
IMG_3326.MOV,45,1625,655,1739,912,2,0,257
IMG_3326.MOV,46,1628,658,1740,910,2,0,252
IMG_3326.MOV,47,1630,661,1740,910,2,0,249
IMG_3326.MOV,48,1632,664,1741,909,2,0,245
IMG_3326.MOV,49,1632,663,1742,909,2,0,246
IMG_3326.MOV,50,1634,662,1744,910,2,0,248
IMG_3326.MOV,51,1634,661,1746,911,2,0,250
IMG_3326.MOV,52,1632,656,1750,921,2,0,265
IMG_3326.MOV,53,1642,658,1761,922,2,0,264
IMG_3326.MOV,54,1645,658,1766,924,2,0,266
IMG_3326.MOV,55,1646,660,1767,925,2,0,265
IMG_3326.MOV,56,1647,663,1767,923,2,0,260
IMG_3326.MOV,57,1648,666,1766,922,2,0,256
IMG_3326.MOV,58,1648,664,1768,922,2,0,258
IMG_3326.MOV,59,1651,662,1771,920,2,0,258
IMG_3326.MOV,60,1652,662,1773,920,2,0,258
IMG_3326.MOV,61,1654,663,1775,919,2,0,256
IMG_3326.MOV,62,1657,663,1778,917,2,0,254
IMG_3326.MOV,63,1660,662,1781,916,2,0,254
IMG_3326.MOV,64,1664,662,1785,914,2,0,252
IMG_3326.MOV,65,1666,660,1789,915,2,0,255
IMG_3326.MOV,66,1667,660,1792,917,2,0,257
IMG_3326.MOV,67,1668,660,1795,919,2,0,259
IMG_3326.MOV,68,1669,659,1798,922,2,0,263
IMG_3326.MOV,69,1672,659,1802,921,2,0,262
IMG_3326.MOV,70,1675,660,1803,920,2,0,260
IMG_3326.MOV,71,1677,661,1806,922,2,0,261
IMG_3326.MOV,72,1679,661,1809,925,2,0,264
IMG_3326.MOV,73,1681,662,1810,926,2,0,264
IMG_3326.MOV,74,1683,662,1811,926,2,0,264
IMG_3326.MOV,75,1684,663,1811,928,2,0,265
IMG_3326.MOV,76,1684,663,1811,932,2,0,269
IMG_3326.MOV,77,1685,663,1811,936,2,0,273
IMG_3326.MOV,78,1686,665,1812,939,2,0,274
IMG_3326.MOV,79,1687,667,1811,941,2,0,274
IMG_3326.MOV,80,1689,667,1812,942,2,0,275
IMG_3326.MOV,81,1691,668,1812,942,2,0,274
IMG_3326.MOV,82,1692,669,1811,942,2,0,273
IMG_3326.MOV,83,1693,670,1811,944,2,0,274
IMG_3326.MOV,84,1694,670,1811,945,2,0,275
IMG_3326.MOV,85,1696,671,1810,943,2,0,272
IMG_3326.MOV,86,1697,672,1809,940,2,0,268
IMG_3326.MOV,87,1698,673,1808,938,2,0,265
IMG_3326.MOV,88,1700,675,1807,931,2,0,256
IMG_3326.MOV,89,1703,676,1807,924,2,0,248
IMG_3326.MOV,90,1705,677,1807,922,2,0,245
IMG_3326.MOV,91,1705,678,1807,922,2,0,244
IMG_3326.MOV,92,1706,679,1809,925,2,0,246
IMG_3326.MOV,93,1708,679,1810,925,2,0,246
IMG_3326.MOV,94,1709,678,1812,930,2,0,252
IMG_3326.MOV,95,1710,677,1815,934,2,0,257
IMG_3326.MOV,96,1710,675,1816,937,2,0,262
IMG_3326.MOV,97,1711,674,1816,938,2,0,264
IMG_3326.MOV,98,1711,672,1816,940,2,0,268
IMG_3326.MOV,99,1713,671,1817,940,2,0,269
IMG_3326.MOV,100,1713,672,1817,943,2,0,271
IMG_3326.MOV,101,1722,670,1826,944,2,0,274
IMG_3326.MOV,102,1726,672,1829,944,2,0,272
IMG_3326.MOV,103,1729,674,1829,943,2,0,269
IMG_3326.MOV,104,1730,678,1828,943,2,0,265
IMG_3326.MOV,105,1731,680,1828,944,2,0,264
IMG_3326.MOV,106,1732,683,1827,944,2,0,261
IMG_3326.MOV,107,1734,685,1827,944,2,0,259
IMG_3326.MOV,108,1734,686,1826,945,2,0,259
IMG_3326.MOV,109,1734,686,1827,947,2,0,261
IMG_3326.MOV,110,1734,686,1826,950,2,0,264
IMG_3326.MOV,111,1734,691,1823,949,2,0,258
IMG_3326.MOV,112,1734,688,1823,951,2,0,263
IMG_3326.MOV,113,1734,687,1823,952,2,0,265
IMG_3326.MOV,114,1734,686,1823,951,2,0,265
IMG_3326.MOV,115,1734,685,1823,951,2,0,266
IMG_3326.MOV,116,1734,685,1822,950,2,0,265
IMG_3326.MOV,117,1727,688,1812,948,2,0,260
IMG_3326.MOV,118,1731,685,1818,949,2,0,264
IMG_3326.MOV,119,1734,682,1821,952,2,0,270
IMG_3326.MOV,120,1734,680,1823,953,2,0,273
IMG_3326.MOV,121,1735,680,1823,953,2,0,273
IMG_3326.MOV,122,1736,680,1823,952,2,0,272
IMG_3326.MOV,123,1736,681,1824,952,2,0,271
IMG_3326.MOV,124,1736,681,1824,952,2,0,271
IMG_3326.MOV,125,1736,681,1824,954,2,0,273
IMG_3326.MOV,126,1736,683,1824,956,2,0,273
IMG_3326.MOV,127,1736,685,1824,959,2,0,274
IMG_3326.MOV,128,1735,685,1824,961,2,0,276
IMG_3326.MOV,129,1735,685,1824,961,2,0,276
IMG_3326.MOV,130,1736,685,1824,962,2,0,277
IMG_3326.MOV,131,1736,686,1825,961,2,0,275
IMG_3326.MOV,132,1738,686,1826,959,2,0,273
IMG_3326.MOV,133,1740,687,1828,959,2,0,272
IMG_3326.MOV,134,1741,687,1830,959,2,0,272
IMG_3326.MOV,135,1740,687,1830,960,2,0,273
IMG_3326.MOV,136,1741,687,1831,958,2,0,271
IMG_3326.MOV,137,1740,687,1831,960,2,0,273
IMG_3326.MOV,138,1740,687,1832,962,2,0,275
IMG_3326.MOV,139,1740,688,1834,961,2,0,273
IMG_3326.MOV,140,1741,690,1836,962,2,0,272
IMG_3326.MOV,141,1741,691,1837,961,2,0,270
IMG_3326.MOV,142,1741,692,1839,961,2,0,269
IMG_3326.MOV,143,1740,691,1840,961,2,0,270
IMG_3326.MOV,144,1740,690,1841,961,2,0,271
IMG_3326.MOV,145,1740,689,1843,963,2,0,274
IMG_3326.MOV,146,1740,689,1844,963,2,0,274
IMG_3326.MOV,147,1740,688,1846,964,2,0,276
IMG_3326.MOV,148,1740,688,1846,964,2,0,276
IMG_3326.MOV,149,1741,689,1847,964,2,0,275
IMG_3326.MOV,150,1741,689,1846,963,2,0,274
IMG_3326.MOV,151,1743,692,1847,961,2,0,269
IMG_3326.MOV,152,1745,703,1849,970,2,0,267
IMG_3326.MOV,153,1747,707,1850,974,2,0,267
IMG_3326.MOV,154,1748,710,1851,975,2,0,265
IMG_3326.MOV,155,1750,712,1851,975,2,0,263
IMG_3326.MOV,156,1751,710,1853,976,2,0,266
IMG_3326.MOV,157,1753,709,1856,977,2,0,268
IMG_3326.MOV,158,1752,711,1856,978,2,0,267
IMG_3326.MOV,159,1752,712,1857,979,2,0,267
IMG_3326.MOV,160,1753,714,1859,979,2,0,265
IMG_3326.MOV,161,1757,713,1862,977,2,0,264
IMG_3326.MOV,162,1759,712,1867,987,2,0,275
IMG_3326.MOV,163,1762,709,1873,995,2,0,286
IMG_3326.MOV,164,1764,708,1876,1000,2,0,292
IMG_3326.MOV,165,1768,708,1879,1002,2,0,294
IMG_3326.MOV,166,1771,710,1881,1005,2,0,295
IMG_3326.MOV,167,1772,713,1881,1010,2,0,297
IMG_3326.MOV,168,1778,720,1879,995,2,0,275
IMG_3326.MOV,169,1781,720,1881,990,2,0,270
IMG_3326.MOV,170,1776,715,1882,1001,2,0,286
IMG_3326.MOV,171,1773,714,1882,1009,2,0,295
IMG_3326.MOV,172,1774,716,1883,1013,2,0,297
IMG_3326.MOV,173,1776,718,1886,1017,2,0,299
IMG_3326.MOV,174,1779,720,1888,1017,2,0,297
IMG_3326.MOV,175,1781,723,1888,1017,2,0,294
IMG_3326.MOV,176,1783,724,1889,1015,2,0,291
IMG_3326.MOV,177,1784,727,1888,1011,2,0,284
IMG_3326.MOV,178,1786,728,1889,1008,2,0,280
IMG_3326.MOV,179,1786,729,1890,1008,2,0,279
IMG_3326.MOV,180,1796,730,1904,1013,2,0,283
IMG_3326.MOV,181,1800,731,1909,1013,2,0,282
IMG_3326.MOV,182,1804,734,1911,1008,2,0,274
IMG_3326.MOV,183,1806,739,1912,1005,2,0,266
IMG_3326.MOV,184,1805,740,1913,1009,2,0,269
IMG_3326.MOV,185,1804,744,1912,1012,2,0,268
IMG_3326.MOV,186,1803,744,1913,1012,2,0,268
IMG_3326.MOV,187,1804,739,1916,1009,2,0,270
IMG_3326.MOV,188,1807,736,1916,996,2,0,260
IMG_3326.MOV,189,1808,734,1919,1002,2,0,268
IMG_3326.MOV,190,1809,733,1924,1013,2,0,280
IMG_3326.MOV,191,1810,732,1927,1021,2,0,289
IMG_3326.MOV,192,1812,732,1928,1021,2,0,289
IMG_3326.MOV,193,1815,733,1928,1020,2,0,287
IMG_3326.MOV,194,1817,733,1928,1019,2,0,286
IMG_3326.MOV,195,1819,733,1927,1012,2,0,279
IMG_3326.MOV,196,1819,734,1927,1018,2,0,284
IMG_3326.MOV,197,1819,736,1927,1021,2,0,285
IMG_3326.MOV,198,1819,736,1928,1027,2,0,291
IMG_3326.MOV,199,1820,738,1928,1032,2,0,294
IMG_3326.MOV,200,1821,740,1928,1035,2,0,295
IMG_3326.MOV,201,1821,741,1929,1043,2,0,302
IMG_3326.MOV,202,1822,741,1928,1042,2,0,301
IMG_3326.MOV,203,1821,740,1926,1041,2,0,301
IMG_3326.MOV,204,1823,741,1927,1042,2,0,301
IMG_3326.MOV,205,1824,739,1928,1046,2,0,307
IMG_3326.MOV,206,1825,738,1929,1048,2,0,310
IMG_3326.MOV,207,1827,736,1930,1048,2,0,312
IMG_3326.MOV,208,1830,734,1930,1045,2,0,311
IMG_3326.MOV,209,1830,729,1931,1052,2,0,323
IMG_3326.MOV,210,1828,723,1932,1059,2,0,336
IMG_3326.MOV,211,1827,718,1931,1063,2,0,345
IMG_3326.MOV,212,1827,711,1931,1064,2,0,353
IMG_3326.MOV,213,1834,710,1933,1057,2,0,347
IMG_3326.MOV,214,1833,703,1932,1057,2,0,354
IMG_3326.MOV,215,1834,702,1931,1060,2,0,358
IMG_3326.MOV,216,1831,688,1931,1063,2,0,375
IMG_3326.MOV,217,1831,684,1932,1064,2,1,380
IMG_3326.MOV,1,187,393,285,651,3,0,258
IMG_3326.MOV,2,188,395,285,651,3,0,256
IMG_3326.MOV,3,190,396,286,651,3,0,255
IMG_3326.MOV,4,190,397,286,651,3,0,254
IMG_3326.MOV,5,191,398,287,651,3,0,253
IMG_3326.MOV,6,191,397,287,652,3,0,255
IMG_3326.MOV,7,191,396,287,652,3,0,256
IMG_3326.MOV,8,190,396,287,652,3,0,256
IMG_3326.MOV,9,190,395,287,652,3,0,257
IMG_3326.MOV,10,190,394,288,652,3,0,258
IMG_3326.MOV,11,191,393,289,650,3,0,257
IMG_3326.MOV,12,192,393,289,649,3,0,256
IMG_3326.MOV,13,192,392,290,649,3,0,257
IMG_3326.MOV,14,192,391,291,648,3,0,257
IMG_3326.MOV,15,193,390,292,648,3,0,258
IMG_3326.MOV,16,193,389,292,648,3,0,259
IMG_3326.MOV,17,196,391,295,647,3,0,256
IMG_3326.MOV,18,198,391,297,647,3,0,256
IMG_3326.MOV,19,198,391,299,647,3,0,256
IMG_3326.MOV,20,198,390,300,648,3,0,258
IMG_3326.MOV,21,200,391,301,648,3,0,257
IMG_3326.MOV,22,201,393,303,650,3,0,257
IMG_3326.MOV,23,202,394,304,651,3,0,257
IMG_3326.MOV,24,204,395,305,651,3,0,256
IMG_3326.MOV,25,204,396,305,651,3,0,255
IMG_3326.MOV,26,203,395,305,652,3,0,257
IMG_3326.MOV,27,202,394,305,653,3,0,259
IMG_3326.MOV,28,202,394,306,654,3,0,260
IMG_3326.MOV,29,202,396,307,656,3,0,260
IMG_3326.MOV,30,203,397,307,655,3,0,258
IMG_3326.MOV,31,204,398,307,655,3,0,257
IMG_3326.MOV,32,205,399,308,654,3,0,255
IMG_3326.MOV,33,207,400,309,654,3,0,254
IMG_3326.MOV,34,208,401,309,654,3,0,253
IMG_3326.MOV,35,208,402,308,654,3,0,252
IMG_3326.MOV,36,208,403,308,655,3,0,252
IMG_3326.MOV,37,209,404,308,655,3,0,251
IMG_3326.MOV,38,212,407,309,654,3,0,247
IMG_3326.MOV,39,213,406,311,655,3,0,249
IMG_3326.MOV,40,214,405,311,655,3,0,250
IMG_3326.MOV,41,213,405,311,656,3,0,251
IMG_3326.MOV,42,213,405,311,656,3,0,251
IMG_3326.MOV,43,214,406,312,656,3,0,250
IMG_3326.MOV,44,214,407,312,656,3,0,249
IMG_3326.MOV,45,214,406,313,656,3,0,250
IMG_3326.MOV,46,216,407,314,655,3,0,248
IMG_3326.MOV,47,216,407,315,655,3,0,248
IMG_3326.MOV,48,218,407,316,655,3,0,248
IMG_3326.MOV,49,222,416,319,664,3,0,248
IMG_3326.MOV,50,223,414,322,672,3,0,258
IMG_3326.MOV,51,226,414,324,674,3,0,260
IMG_3326.MOV,52,228,409,324,664,3,0,255
IMG_3326.MOV,53,228,410,325,672,3,0,262
IMG_3326.MOV,54,229,410,326,676,3,0,266
IMG_3326.MOV,55,231,410,327,678,3,0,268
IMG_3326.MOV,56,233,411,327,677,3,0,266
IMG_3326.MOV,57,234,412,326,677,3,0,265
IMG_3326.MOV,58,236,415,325,676,3,0,261
IMG_3326.MOV,59,235,415,323,675,3,0,260
IMG_3326.MOV,60,236,415,324,676,3,0,261
IMG_3326.MOV,61,237,415,324,675,3,0,260
IMG_3326.MOV,62,238,415,324,675,3,0,260
IMG_3326.MOV,63,239,416,324,674,3,0,258
IMG_3326.MOV,64,239,417,324,675,3,0,258
IMG_3326.MOV,65,240,416,326,675,3,0,259
IMG_3326.MOV,66,240,417,327,676,3,0,259
IMG_3326.MOV,67,241,418,328,677,3,0,259
IMG_3326.MOV,68,241,416,329,679,3,0,263
IMG_3326.MOV,69,241,417,331,679,3,0,262
IMG_3326.MOV,70,241,417,332,679,3,0,262
IMG_3326.MOV,71,240,417,333,680,3,0,263
IMG_3326.MOV,72,240,417,333,680,3,0,263
IMG_3326.MOV,73,239,417,335,681,3,0,264
IMG_3326.MOV,74,249,418,345,680,3,0,262
IMG_3326.MOV,75,252,418,350,680,3,0,262
IMG_3326.MOV,76,252,419,352,680,3,0,261
IMG_3326.MOV,77,252,419,353,680,3,0,261
IMG_3326.MOV,78,252,419,355,679,3,0,260
IMG_3326.MOV,79,252,418,357,679,3,0,261
IMG_3326.MOV,80,252,418,358,679,3,0,261
IMG_3326.MOV,81,251,417,359,679,3,0,262
IMG_3326.MOV,82,251,417,360,679,3,0,262
IMG_3326.MOV,83,251,417,360,679,3,0,262
IMG_3326.MOV,84,251,419,359,679,3,0,260
IMG_3326.MOV,85,251,419,359,678,3,0,259
IMG_3326.MOV,86,253,418,360,678,3,0,260
IMG_3326.MOV,87,253,418,359,678,3,0,260
IMG_3326.MOV,88,253,418,358,679,3,0,261
IMG_3326.MOV,89,253,419,358,680,3,0,261
IMG_3326.MOV,90,253,420,357,680,3,0,260
IMG_3326.MOV,91,252,421,356,681,3,0,260
IMG_3326.MOV,92,252,420,356,681,3,0,261
IMG_3326.MOV,93,252,420,355,681,3,0,261
IMG_3326.MOV,94,253,423,353,680,3,0,257
IMG_3326.MOV,95,253,423,353,682,3,0,259
IMG_3326.MOV,96,254,421,354,684,3,0,263
IMG_3326.MOV,97,255,419,354,684,3,0,265
IMG_3326.MOV,98,258,419,355,685,3,0,266
IMG_3326.MOV,99,259,419,356,685,3,0,266
IMG_3326.MOV,100,260,419,355,685,3,0,266
IMG_3326.MOV,101,261,418,355,682,3,0,264
IMG_3326.MOV,102,260,418,355,682,3,0,264
IMG_3326.MOV,103,261,415,357,683,3,0,268
IMG_3326.MOV,104,261,412,360,688,3,0,276
IMG_3326.MOV,105,261,407,364,694,3,0,287
IMG_3326.MOV,106,262,409,365,695,3,0,286
IMG_3326.MOV,107,265,414,364,690,3,0,276
IMG_3326.MOV,108,266,416,365,690,3,0,274
IMG_3326.MOV,109,268,416,366,688,3,0,272
IMG_3326.MOV,110,268,415,367,688,3,0,273
IMG_3326.MOV,111,270,420,370,694,3,0,274
IMG_3326.MOV,112,272,419,373,698,3,0,279
IMG_3326.MOV,113,271,418,374,700,3,0,282
IMG_3326.MOV,114,271,418,376,701,3,0,283
IMG_3326.MOV,115,271,416,378,702,3,0,286
IMG_3326.MOV,116,271,412,380,703,3,0,291
IMG_3326.MOV,117,271,413,381,703,3,0,290
IMG_3326.MOV,118,272,416,380,701,3,0,285
IMG_3326.MOV,119,270,415,380,701,3,0,286
IMG_3326.MOV,120,270,417,379,700,3,0,283
IMG_3326.MOV,121,271,423,379,700,3,0,277
IMG_3326.MOV,122,271,428,378,700,3,0,272
IMG_3326.MOV,123,271,427,379,701,3,0,274
IMG_3326.MOV,124,271,420,382,703,3,0,283
IMG_3326.MOV,125,271,414,385,706,3,0,292
IMG_3326.MOV,126,272,410,387,707,3,0,297
IMG_3326.MOV,127,275,416,386,707,3,0,291
IMG_3326.MOV,128,276,418,386,707,3,0,289
IMG_3326.MOV,129,277,416,388,708,3,0,292
IMG_3326.MOV,130,277,410,389,709,3,0,299
IMG_3326.MOV,131,277,407,390,710,3,0,303
IMG_3326.MOV,132,278,404,390,710,3,0,306
IMG_3326.MOV,133,278,400,391,710,3,0,310
IMG_3326.MOV,134,277,398,390,711,3,0,313
IMG_3326.MOV,135,277,400,390,711,3,0,311
IMG_3326.MOV,136,280,406,391,709,3,0,303
IMG_3326.MOV,137,283,414,390,709,3,0,295
IMG_3326.MOV,138,286,418,392,708,3,0,290
IMG_3326.MOV,139,288,418,393,707,3,0,289
IMG_3326.MOV,140,291,419,396,707,3,0,288
IMG_3326.MOV,141,293,420,396,707,3,0,287
IMG_3326.MOV,142,295,421,397,708,3,0,287
IMG_3326.MOV,143,297,421,398,708,3,0,287
IMG_3326.MOV,144,298,420,398,707,3,0,287
IMG_3326.MOV,145,298,422,397,705,3,0,283
IMG_3326.MOV,146,297,425,395,705,3,0,280
IMG_3326.MOV,147,297,426,395,706,3,0,280
IMG_3326.MOV,148,297,425,395,708,3,0,283
IMG_3326.MOV,149,296,425,394,708,3,0,283
IMG_3326.MOV,150,297,428,394,707,3,0,279
IMG_3326.MOV,151,298,430,395,706,3,0,276
IMG_3326.MOV,152,301,431,397,705,3,0,274
IMG_3326.MOV,153,304,432,399,705,3,0,273
IMG_3326.MOV,154,305,432,400,705,3,0,273
IMG_3326.MOV,155,306,432,400,706,3,0,274
IMG_3326.MOV,156,308,430,402,708,3,0,278
IMG_3326.MOV,157,310,428,403,709,3,0,281
IMG_3326.MOV,158,310,427,403,711,3,0,284
IMG_3326.MOV,159,310,426,403,712,3,0,286
IMG_3326.MOV,160,310,424,402,711,3,0,287
IMG_3326.MOV,161,309,424,401,712,3,0,288
IMG_3326.MOV,162,308,423,401,713,3,0,290
IMG_3326.MOV,163,308,421,400,712,3,0,291
IMG_3326.MOV,164,308,421,401,712,3,0,291
IMG_3326.MOV,165,309,420,400,711,3,0,291
IMG_3326.MOV,166,310,419,401,710,3,0,291
IMG_3326.MOV,167,310,421,400,710,3,0,289
IMG_3326.MOV,168,310,423,400,709,3,0,286
IMG_3326.MOV,169,310,423,399,709,3,0,286
IMG_3326.MOV,170,309,424,398,708,3,0,284
IMG_3326.MOV,171,309,425,398,708,3,0,283
IMG_3326.MOV,172,309,425,398,709,3,0,284
IMG_3326.MOV,173,309,424,399,709,3,0,285
IMG_3326.MOV,174,308,422,399,709,3,0,287
IMG_3326.MOV,175,307,418,400,709,3,0,291
IMG_3326.MOV,176,306,415,401,709,3,0,294
IMG_3326.MOV,177,305,412,401,709,3,0,297
IMG_3326.MOV,178,303,411,401,709,3,0,298
IMG_3326.MOV,179,302,412,401,710,3,0,298
IMG_3326.MOV,180,301,414,399,709,3,0,295
IMG_3326.MOV,181,302,419,399,708,3,0,289
IMG_3326.MOV,182,302,422,400,708,3,0,286
IMG_3326.MOV,183,302,423,401,709,3,0,286
IMG_3326.MOV,184,302,424,401,710,3,0,286
IMG_3326.MOV,185,302,424,402,710,3,0,286
IMG_3326.MOV,186,302,422,404,710,3,0,288
IMG_3326.MOV,187,303,423,405,709,3,0,286
IMG_3326.MOV,188,304,423,407,709,3,0,286
IMG_3326.MOV,189,305,423,409,709,3,0,286
IMG_3326.MOV,190,304,425,409,710,3,0,285
IMG_3326.MOV,191,304,425,410,710,3,0,285
IMG_3326.MOV,192,303,424,410,709,3,0,285
IMG_3326.MOV,193,303,423,411,709,3,0,286
IMG_3326.MOV,194,304,423,412,707,3,0,284
IMG_3326.MOV,195,304,426,411,708,3,0,282
IMG_3326.MOV,196,305,429,412,709,3,0,280
IMG_3326.MOV,197,316,427,425,713,3,0,286
IMG_3326.MOV,198,319,428,430,716,3,0,288
IMG_3326.MOV,199,321,427,433,718,3,0,291
IMG_3326.MOV,200,320,427,434,720,3,0,293
IMG_3326.MOV,201,321,426,435,721,3,0,295
IMG_3326.MOV,202,321,424,436,720,3,0,296
IMG_3326.MOV,203,320,424,436,721,3,0,297
IMG_3326.MOV,204,320,424,436,722,3,0,298
IMG_3326.MOV,205,320,424,437,721,3,0,297
IMG_3326.MOV,206,321,427,437,721,3,0,294
IMG_3326.MOV,207,320,427,438,723,3,0,296
IMG_3326.MOV,208,321,429,439,726,3,0,297
IMG_3326.MOV,209,321,429,440,728,3,0,299
IMG_3326.MOV,210,321,430,440,730,3,0,300
IMG_3326.MOV,211,320,431,440,733,3,0,302
IMG_3326.MOV,212,320,430,440,733,3,0,303
IMG_3326.MOV,213,321,430,440,732,3,0,302
IMG_3326.MOV,214,323,429,441,732,3,0,303
IMG_3326.MOV,215,323,429,441,730,3,0,301
IMG_3326.MOV,216,325,431,442,729,3,0,298
IMG_3326.MOV,217,326,431,443,728,3,0,297
IMG_3326.MOV,218,326,429,444,727,3,0,298
IMG_3326.MOV,219,327,428,444,726,3,0,298
IMG_3326.MOV,220,327,428,445,726,3,0,298
IMG_3326.MOV,221,329,430,446,726,3,0,296
IMG_3326.MOV,222,331,428,447,725,3,0,297
IMG_3326.MOV,223,332,428,448,726,3,0,298
IMG_3326.MOV,224,332,428,448,726,3,0,298
IMG_3326.MOV,225,331,428,448,727,3,0,299
IMG_3326.MOV,226,332,428,448,728,3,0,300
IMG_3326.MOV,227,333,430,449,729,3,0,299
IMG_3326.MOV,228,335,433,450,729,3,0,296
IMG_3326.MOV,229,337,436,452,729,3,0,293
IMG_3326.MOV,230,337,436,452,730,3,0,294
IMG_3326.MOV,231,336,436,453,730,3,0,294
IMG_3326.MOV,232,337,435,455,731,3,0,296
IMG_3326.MOV,233,343,435,459,733,3,0,298
IMG_3326.MOV,234,346,434,462,735,3,0,301
IMG_3326.MOV,235,347,434,462,735,3,0,301
IMG_3326.MOV,236,348,434,461,735,3,0,301
IMG_3326.MOV,237,353,434,463,735,3,0,301
IMG_3326.MOV,238,359,435,466,735,3,0,300
IMG_3326.MOV,239,361,435,467,736,3,0,301
IMG_3326.MOV,240,365,435,468,737,3,0,302
IMG_3326.MOV,241,365,433,468,737,3,0,304
IMG_3326.MOV,242,364,431,465,737,3,0,306
IMG_3326.MOV,243,362,429,462,736,3,0,307
IMG_3326.MOV,244,364,430,463,736,3,0,306
IMG_3326.MOV,245,367,430,464,735,3,0,305
IMG_3326.MOV,246,368,431,463,735,3,0,304
IMG_3326.MOV,247,368,431,463,737,3,0,306
IMG_3326.MOV,248,369,430,464,739,3,0,309
IMG_3326.MOV,249,371,430,465,741,3,0,311
IMG_3326.MOV,250,368,428,464,743,3,0,315
IMG_3326.MOV,251,367,430,463,743,3,0,313
IMG_3326.MOV,252,366,429,462,743,3,0,314
IMG_3326.MOV,253,365,428,463,743,3,0,315
IMG_3326.MOV,254,368,428,465,743,3,0,315
IMG_3326.MOV,255,368,428,465,741,3,0,313
IMG_3326.MOV,256,365,428,462,740,3,0,312
IMG_3326.MOV,257,365,430,462,739,3,0,309
IMG_3326.MOV,258,366,432,463,737,3,0,305
IMG_3326.MOV,259,367,437,463,735,3,0,298
IMG_3326.MOV,260,369,445,462,732,3,0,287
IMG_3326.MOV,261,368,447,462,731,3,0,284
IMG_3326.MOV,262,367,447,463,730,3,0,283
IMG_3326.MOV,263,370,446,467,730,3,0,284
IMG_3326.MOV,264,371,448,468,730,3,0,282
IMG_3326.MOV,265,370,449,468,730,3,0,281
IMG_3326.MOV,266,370,449,469,730,3,0,281
IMG_3326.MOV,267,371,447,471,730,3,0,283
IMG_3326.MOV,268,373,445,474,732,3,0,287
IMG_3326.MOV,269,374,443,476,732,3,0,289
IMG_3326.MOV,270,374,442,477,733,3,0,291
IMG_3326.MOV,271,374,440,479,733,3,0,293
IMG_3326.MOV,272,376,440,481,733,3,0,293
IMG_3326.MOV,273,376,439,481,732,3,0,293
IMG_3326.MOV,274,379,440,484,732,3,0,292
IMG_3326.MOV,275,380,440,486,732,3,0,292
IMG_3326.MOV,276,379,440,485,733,3,0,293
IMG_3326.MOV,277,378,440,485,733,3,0,293
IMG_3326.MOV,278,378,437,490,741,3,0,304
IMG_3326.MOV,279,391,441,500,737,3,0,296
IMG_3326.MOV,280,396,443,505,735,3,0,292
IMG_3326.MOV,281,398,444,506,733,3,0,289
IMG_3326.MOV,282,398,441,508,734,3,0,293
IMG_3326.MOV,283,399,441,510,735,3,0,294
IMG_3326.MOV,284,400,441,511,737,3,0,296
IMG_3326.MOV,285,399,440,512,738,3,0,298
IMG_3326.MOV,286,397,439,511,740,3,0,301
IMG_3326.MOV,287,395,437,512,743,3,0,306
IMG_3326.MOV,288,395,436,512,744,3,0,308
IMG_3326.MOV,289,395,435,514,746,3,0,311
IMG_3326.MOV,290,395,432,515,747,3,0,315
IMG_3326.MOV,291,395,431,517,749,3,0,318
IMG_3326.MOV,292,395,430,518,751,3,0,321
IMG_3326.MOV,293,395,429,520,753,3,0,324
IMG_3326.MOV,294,395,428,521,755,3,0,327
IMG_3326.MOV,295,396,428,522,756,3,0,328
IMG_3326.MOV,296,395,428,522,757,3,0,329
IMG_3326.MOV,297,397,433,520,753,3,0,320
IMG_3326.MOV,298,396,429,522,756,3,0,327
IMG_3326.MOV,299,396,427,523,757,3,0,330
IMG_3326.MOV,300,397,429,525,757,3,0,328
IMG_3326.MOV,301,399,430,525,756,3,0,326
IMG_3326.MOV,302,399,432,524,754,3,0,322
IMG_3326.MOV,303,401,434,525,752,3,0,318
IMG_3326.MOV,304,401,436,524,750,3,0,314
IMG_3326.MOV,305,400,434,525,750,3,0,316
IMG_3326.MOV,306,400,435,525,751,3,0,316
IMG_3326.MOV,307,401,434,528,752,3,0,318
IMG_3326.MOV,308,401,434,530,752,3,0,318
IMG_3326.MOV,309,401,434,530,753,3,0,319
IMG_3326.MOV,310,404,433,533,750,3,0,317
IMG_3326.MOV,311,406,434,534,749,3,0,315
IMG_3326.MOV,312,406,434,534,748,3,0,314
IMG_3326.MOV,313,409,433,537,748,3,0,315
IMG_3326.MOV,314,412,432,542,748,3,0,316
IMG_3326.MOV,315,415,432,546,747,3,0,315
IMG_3326.MOV,316,416,433,548,746,3,0,313
IMG_3326.MOV,317,418,434,550,745,3,0,311
IMG_3326.MOV,318,421,434,553,744,3,0,310
IMG_3326.MOV,319,423,434,556,744,3,0,310
IMG_3326.MOV,320,423,435,556,744,3,0,309
IMG_3326.MOV,321,422,434,557,744,3,0,310
IMG_3326.MOV,322,422,434,558,746,3,0,312
IMG_3326.MOV,323,423,434,559,746,3,0,312
IMG_3326.MOV,324,424,437,561,750,3,0,313
IMG_3326.MOV,325,426,438,563,753,3,0,315
IMG_3326.MOV,326,425,438,563,755,3,0,317
IMG_3326.MOV,327,426,438,563,755,3,0,317
IMG_3326.MOV,328,427,437,564,755,3,0,318
IMG_3326.MOV,329,427,436,564,755,3,0,319
IMG_3326.MOV,330,428,435,564,754,3,0,319
IMG_3326.MOV,331,430,435,565,752,3,0,317
IMG_3326.MOV,332,431,435,566,752,3,0,317
IMG_3326.MOV,333,432,435,566,752,3,0,317
IMG_3326.MOV,334,432,434,566,752,3,0,318
IMG_3326.MOV,335,433,437,563,747,3,0,310
IMG_3326.MOV,336,434,437,562,745,3,0,308
IMG_3326.MOV,337,434,438,561,744,3,0,306
IMG_3326.MOV,338,433,438,560,744,3,0,306
IMG_3326.MOV,339,433,437,559,744,3,0,307
IMG_3326.MOV,340,434,437,559,744,3,0,307
IMG_3326.MOV,341,434,436,560,743,3,0,307
IMG_3326.MOV,342,434,434,561,744,3,0,310
IMG_3326.MOV,343,434,433,563,747,3,0,314
IMG_3326.MOV,344,434,433,564,748,3,0,315
IMG_3326.MOV,345,434,433,565,748,3,0,315
IMG_3326.MOV,346,434,433,565,747,3,0,314
IMG_3326.MOV,347,434,433,565,746,3,0,313
IMG_3326.MOV,348,433,433,565,748,3,0,315
IMG_3326.MOV,349,432,434,565,751,3,0,317
IMG_3326.MOV,350,431,434,565,754,3,0,320
IMG_3326.MOV,351,430,434,566,756,3,0,322
IMG_3326.MOV,352,430,434,566,757,3,0,323
IMG_3326.MOV,353,429,434,566,758,3,0,324
IMG_3326.MOV,354,429,434,566,757,3,0,323
IMG_3326.MOV,355,429,435,565,758,3,0,323
IMG_3326.MOV,356,428,435,564,758,3,0,323
IMG_3326.MOV,357,427,435,563,759,3,0,324
IMG_3326.MOV,358,428,433,564,759,3,0,326
IMG_3326.MOV,359,431,431,566,758,3,0,327
IMG_3326.MOV,360,433,430,566,758,3,0,328
IMG_3326.MOV,361,435,430,567,758,3,0,328
IMG_3326.MOV,362,436,431,566,758,3,0,327
IMG_3326.MOV,363,439,432,566,756,3,0,324
IMG_3326.MOV,364,440,432,565,756,3,0,324
IMG_3326.MOV,365,440,432,564,757,3,0,325
IMG_3326.MOV,366,440,432,563,757,3,0,325
IMG_3326.MOV,367,440,434,562,756,3,0,322
IMG_3326.MOV,368,441,434,561,756,3,0,322
IMG_3326.MOV,369,440,433,561,756,3,0,323
IMG_3326.MOV,370,440,432,561,758,3,0,326
IMG_3326.MOV,371,441,432,561,759,3,0,327
IMG_3326.MOV,372,441,432,561,759,3,0,327
IMG_3326.MOV,373,442,432,561,759,3,0,327
IMG_3326.MOV,374,441,432,560,759,3,0,327
IMG_3326.MOV,375,443,431,560,759,3,0,328
IMG_3326.MOV,376,443,432,560,758,3,0,326
IMG_3326.MOV,377,443,432,560,758,3,0,326
IMG_3326.MOV,378,443,433,559,760,3,0,327
IMG_3326.MOV,379,444,433,560,760,3,0,327
IMG_3326.MOV,380,445,434,560,760,3,0,326
IMG_3326.MOV,381,446,433,560,759,3,0,326
IMG_3326.MOV,382,446,433,560,758,3,0,325
IMG_3326.MOV,383,446,432,559,758,3,0,326
IMG_3326.MOV,384,446,432,559,758,3,0,326
IMG_3326.MOV,385,446,431,559,757,3,0,326
IMG_3326.MOV,386,447,431,559,757,3,0,326
IMG_3326.MOV,387,447,432,559,755,3,0,323
IMG_3326.MOV,388,449,432,560,756,3,0,324
IMG_3326.MOV,389,449,432,561,758,3,0,326
IMG_3326.MOV,390,450,431,562,758,3,0,327
IMG_3326.MOV,391,451,431,563,758,3,0,327
IMG_3326.MOV,392,450,430,562,758,3,0,328
IMG_3326.MOV,393,450,432,561,758,3,0,326
IMG_3326.MOV,394,450,433,560,756,3,0,323
IMG_3326.MOV,395,449,434,559,755,3,0,321
IMG_3326.MOV,396,451,437,559,751,3,0,314
IMG_3326.MOV,397,453,440,558,747,3,0,307
IMG_3326.MOV,398,454,441,558,745,3,0,304
IMG_3326.MOV,399,455,442,557,744,3,0,302
IMG_3326.MOV,400,456,443,557,742,3,0,299
IMG_3326.MOV,401,456,443,557,742,3,0,299
IMG_3326.MOV,402,456,444,556,742,3,0,298
IMG_3326.MOV,403,464,433,570,754,3,0,321
IMG_3326.MOV,404,468,429,575,758,3,0,329
IMG_3326.MOV,405,469,429,577,761,3,0,332
IMG_3326.MOV,406,471,430,577,762,3,0,332
IMG_3326.MOV,407,472,432,577,763,3,0,331
IMG_3326.MOV,408,472,433,576,764,3,0,331
IMG_3326.MOV,409,473,433,576,764,3,0,331
IMG_3326.MOV,410,474,433,575,763,3,0,330
IMG_3326.MOV,411,475,433,576,762,3,0,329
IMG_3326.MOV,412,477,433,576,762,3,0,329
IMG_3326.MOV,413,477,433,576,763,3,0,330
IMG_3326.MOV,414,478,433,575,762,3,0,329
IMG_3326.MOV,415,478,432,576,764,3,0,332
IMG_3326.MOV,416,479,434,576,763,3,0,329
IMG_3326.MOV,417,479,434,576,763,3,0,329
IMG_3326.MOV,418,480,433,577,762,3,0,329
IMG_3326.MOV,419,482,430,579,760,3,0,330
IMG_3326.MOV,420,484,432,580,760,3,0,328
IMG_3326.MOV,421,486,433,582,763,3,0,330
IMG_3326.MOV,422,491,434,587,762,3,0,328
IMG_3326.MOV,423,494,435,589,762,3,0,327
IMG_3326.MOV,424,498,435,594,762,3,0,327
IMG_3326.MOV,425,503,438,598,761,3,0,323
IMG_3326.MOV,426,507,440,602,761,3,0,321
IMG_3326.MOV,427,509,442,604,761,3,0,319
IMG_3326.MOV,428,510,445,606,762,3,0,317
IMG_3326.MOV,429,512,444,609,763,3,0,319
IMG_3326.MOV,430,515,444,612,764,3,0,320
IMG_3326.MOV,431,516,445,614,764,3,0,319
IMG_3326.MOV,432,517,445,617,766,3,0,321
IMG_3326.MOV,433,520,457,619,773,3,0,316
IMG_3326.MOV,434,520,457,622,780,3,0,323
IMG_3326.MOV,435,520,459,623,781,3,0,322
IMG_3326.MOV,436,519,459,623,781,3,0,322
IMG_3326.MOV,437,519,464,623,779,3,0,315
IMG_3326.MOV,438,516,478,619,778,3,0,300
IMG_3326.MOV,439,520,477,624,779,3,0,302
IMG_3326.MOV,440,521,470,628,782,3,0,312
IMG_3326.MOV,441,521,469,628,783,3,0,314
IMG_3326.MOV,442,523,470,629,783,3,0,313
IMG_3326.MOV,443,524,466,632,784,3,0,318
IMG_3326.MOV,444,536,459,645,787,3,0,328
IMG_3326.MOV,445,543,458,651,786,3,0,328
IMG_3326.MOV,446,549,460,655,786,3,0,326
IMG_3326.MOV,447,551,460,657,789,3,0,329
IMG_3326.MOV,448,554,466,658,790,3,0,324
IMG_3326.MOV,449,558,469,662,789,3,0,320
IMG_3326.MOV,450,562,471,665,790,3,0,319
IMG_3326.MOV,451,566,472,668,789,3,0,317
IMG_3326.MOV,452,568,471,671,791,3,0,320
IMG_3326.MOV,453,569,471,673,794,3,0,323
IMG_3326.MOV,454,571,472,675,793,3,0,321
IMG_3326.MOV,455,579,471,685,792,3,0,321
IMG_3326.MOV,456,581,472,690,796,3,0,324
IMG_3326.MOV,457,580,475,691,795,3,0,320
IMG_3326.MOV,458,581,478,693,792,3,0,314
IMG_3326.MOV,459,584,482,696,793,3,0,311
IMG_3326.MOV,460,586,480,701,793,3,0,313
IMG_3326.MOV,461,585,477,704,797,3,0,320
IMG_3326.MOV,462,586,478,707,800,3,0,322
IMG_3326.MOV,463,587,478,709,802,3,0,324
IMG_3326.MOV,464,590,478,712,801,3,0,323
IMG_3326.MOV,465,593,480,715,802,3,0,322
IMG_3326.MOV,466,597,486,715,801,3,0,315
IMG_3326.MOV,467,608,491,723,799,3,0,308
IMG_3326.MOV,468,614,492,728,797,3,0,305
IMG_3326.MOV,469,617,491,732,798,3,0,307
IMG_3326.MOV,470,622,494,735,797,3,0,303
IMG_3326.MOV,471,627,498,739,797,3,0,299
IMG_3326.MOV,472,631,501,742,798,3,0,297
IMG_3326.MOV,473,634,504,746,801,3,0,297
IMG_3326.MOV,474,636,501,751,806,3,0,305
IMG_3326.MOV,475,637,499,754,808,3,0,309
IMG_3326.MOV,476,640,502,757,807,3,0,305
IMG_3326.MOV,477,639,501,758,808,3,0,307
IMG_3326.MOV,478,639,496,760,810,3,0,314
IMG_3326.MOV,479,640,493,764,811,3,0,318
IMG_3326.MOV,480,644,493,768,809,3,0,316
IMG_3326.MOV,481,648,493,773,808,3,0,315
IMG_3326.MOV,482,651,492,777,808,3,0,316
IMG_3326.MOV,483,653,490,781,810,3,0,320
IMG_3326.MOV,484,655,490,783,810,3,0,320
IMG_3326.MOV,485,658,491,785,809,3,0,318
IMG_3326.MOV,486,658,490,785,809,3,0,319
IMG_3326.MOV,487,659,492,786,810,3,0,318
IMG_3326.MOV,488,660,493,786,811,3,0,318
IMG_3326.MOV,489,660,492,788,813,3,0,321
IMG_3326.MOV,490,661,492,788,812,3,0,320
IMG_3326.MOV,491,664,492,789,811,3,0,319
IMG_3326.MOV,492,667,492,791,810,3,0,318
IMG_3326.MOV,493,678,493,800,810,3,0,317
IMG_3326.MOV,494,685,495,805,809,3,0,314
IMG_3326.MOV,495,691,497,808,809,3,0,312
IMG_3326.MOV,496,695,496,811,809,3,0,313
IMG_3326.MOV,497,697,495,815,809,3,0,314
IMG_3326.MOV,498,699,495,817,811,3,0,316
IMG_3326.MOV,499,704,495,822,811,3,0,316
IMG_3326.MOV,500,708,495,826,812,3,0,317
IMG_3326.MOV,501,710,493,831,816,3,0,323
IMG_3326.MOV,502,711,493,834,817,3,0,324
IMG_3326.MOV,503,711,494,835,817,3,0,323
IMG_3326.MOV,504,711,494,835,815,3,0,321
IMG_3326.MOV,505,713,494,837,809,3,0,315
IMG_3326.MOV,506,715,496,840,808,3,0,312
IMG_3326.MOV,507,719,496,845,810,3,0,314
IMG_3326.MOV,508,722,494,850,809,3,0,315
IMG_3326.MOV,509,725,494,854,811,3,0,317
IMG_3326.MOV,510,727,494,858,811,3,0,317
IMG_3326.MOV,511,729,494,861,810,3,0,316
IMG_3326.MOV,512,729,494,862,810,3,0,316
IMG_3326.MOV,513,731,496,864,812,3,0,316
IMG_3326.MOV,514,733,495,867,814,3,0,319
IMG_3326.MOV,515,735,497,869,815,3,0,318
IMG_3326.MOV,516,736,499,869,815,3,0,316
IMG_3326.MOV,517,737,498,871,815,3,0,317
IMG_3326.MOV,518,749,502,879,809,3,0,307
IMG_3326.MOV,519,755,501,883,807,3,0,306
IMG_3326.MOV,520,759,502,886,807,3,0,305
IMG_3326.MOV,521,760,503,889,809,3,0,306
IMG_3326.MOV,522,759,501,890,813,3,0,312
IMG_3326.MOV,523,757,499,892,819,3,0,320
IMG_3326.MOV,524,759,498,895,822,3,0,324
IMG_3326.MOV,525,764,499,897,818,3,0,319
IMG_3326.MOV,526,769,500,901,815,3,0,315
IMG_3326.MOV,527,775,500,906,816,3,0,316
IMG_3326.MOV,528,781,501,910,812,3,0,311
IMG_3326.MOV,529,784,499,914,818,3,0,319
IMG_3326.MOV,530,789,499,919,819,3,0,320
IMG_3326.MOV,531,794,497,924,820,3,0,323
IMG_3326.MOV,532,798,499,929,822,3,0,323
IMG_3326.MOV,533,798,499,929,825,3,0,326
IMG_3326.MOV,534,801,495,933,821,3,0,326
IMG_3326.MOV,535,805,491,941,823,3,0,332
IMG_3326.MOV,536,809,492,943,820,3,0,328
IMG_3326.MOV,537,807,496,940,826,3,0,330
IMG_3326.MOV,538,808,498,941,829,3,0,331
IMG_3326.MOV,539,808,497,942,832,3,0,335
IMG_3326.MOV,540,806,495,944,839,3,0,344
IMG_3326.MOV,541,802,495,944,843,3,0,348
IMG_3326.MOV,542,818,493,959,838,3,0,345
IMG_3326.MOV,543,822,493,963,839,3,0,346
IMG_3326.MOV,544,806,496,951,847,3,0,351
IMG_3326.MOV,545,800,498,947,848,3,0,350
IMG_3326.MOV,546,815,495,962,842,3,0,347
IMG_3326.MOV,547,822,492,969,841,3,0,349
IMG_3326.MOV,548,826,492,973,842,3,0,350
IMG_3326.MOV,549,828,491,976,845,3,0,354
IMG_3326.MOV,550,828,493,974,844,3,0,351
IMG_3326.MOV,551,830,494,974,845,3,0,351
IMG_3326.MOV,552,832,491,976,850,3,0,359
IMG_3326.MOV,553,839,496,977,850,3,0,354
IMG_3326.MOV,554,840,496,977,851,3,0,355
IMG_3326.MOV,555,844,496,981,852,3,0,356
IMG_3326.MOV,556,845,496,981,855,3,0,359
IMG_3326.MOV,557,846,496,981,857,3,0,361
IMG_3326.MOV,558,852,497,986,858,3,0,361
IMG_3326.MOV,559,860,496,991,856,3,0,360
IMG_3326.MOV,560,866,494,994,850,3,0,356
IMG_3326.MOV,561,869,493,995,848,3,0,355
IMG_3326.MOV,562,874,494,996,840,3,0,346
IMG_3326.MOV,563,880,496,999,836,3,0,340
IMG_3326.MOV,564,880,496,1003,847,3,0,351
IMG_3326.MOV,565,868,502,1001,871,3,0,369
IMG_3326.MOV,566,863,502,1003,881,3,0,379
IMG_3326.MOV,567,873,499,1011,869,3,0,370
IMG_3326.MOV,568,896,497,1026,847,3,0,350
IMG_3326.MOV,569,910,504,1031,826,3,0,322
IMG_3326.MOV,570,917,505,1037,821,3,0,316
IMG_3326.MOV,571,921,504,1042,820,3,0,316
IMG_3326.MOV,572,923,503,1048,825,3,0,322
IMG_3326.MOV,573,929,506,1056,826,3,0,320
IMG_3326.MOV,574,932,508,1062,827,3,0,319
IMG_3326.MOV,575,935,506,1071,833,3,0,327
IMG_3326.MOV,576,904,504,1057,862,3,0,358
IMG_3326.MOV,577,911,504,1065,855,3,0,351
IMG_3326.MOV,578,914,505,1069,851,3,0,346
IMG_3326.MOV,579,914,505,1071,849,3,0,344
IMG_3326.MOV,580,917,503,1073,846,3,0,343
IMG_3326.MOV,581,925,501,1079,838,3,0,337
IMG_3326.MOV,582,933,498,1085,836,3,0,338
IMG_3326.MOV,583,925,496,1082,844,3,0,348
IMG_3326.MOV,584,931,497,1085,841,3,0,344
IMG_3326.MOV,585,933,497,1085,843,3,0,346
IMG_3326.MOV,586,934,497,1085,845,3,0,348
IMG_3326.MOV,587,939,496,1085,840,3,0,344
IMG_3326.MOV,588,943,495,1088,838,3,0,343
IMG_3326.MOV,589,950,496,1090,835,3,0,339
IMG_3326.MOV,590,956,497,1092,830,3,0,333
IMG_3326.MOV,591,959,498,1092,829,3,0,331
IMG_3326.MOV,592,970,498,1102,832,3,0,334
IMG_3326.MOV,593,975,497,1108,835,3,0,338
IMG_3326.MOV,594,980,498,1114,835,3,0,337
IMG_3326.MOV,595,985,499,1119,837,3,0,338
IMG_3326.MOV,596,994,499,1126,837,3,0,338
IMG_3326.MOV,597,1002,499,1134,837,3,0,338
IMG_3326.MOV,598,1008,500,1140,835,3,0,335
IMG_3326.MOV,599,1013,498,1145,832,3,0,334
IMG_3326.MOV,600,1016,499,1146,831,3,0,332
IMG_3326.MOV,601,1020,499,1152,832,3,0,333
IMG_3326.MOV,602,1021,498,1154,833,3,0,335
IMG_3326.MOV,603,1023,498,1157,835,3,0,337
IMG_3326.MOV,604,1026,498,1162,838,3,0,340
IMG_3326.MOV,605,1027,498,1166,840,3,0,342
IMG_3326.MOV,606,1027,500,1168,841,3,0,341
IMG_3326.MOV,607,1027,500,1171,841,3,0,341
IMG_3326.MOV,608,1039,500,1182,840,3,0,340
IMG_3326.MOV,609,1044,500,1188,842,3,0,342
IMG_3326.MOV,610,1048,503,1190,839,3,0,336
IMG_3326.MOV,611,1050,505,1193,841,3,0,336
IMG_3326.MOV,612,1050,505,1192,842,3,0,337
IMG_3326.MOV,613,1052,507,1193,840,3,0,333
IMG_3326.MOV,614,1053,508,1192,838,3,0,330
IMG_3326.MOV,615,1056,506,1195,835,3,0,329
IMG_3326.MOV,616,1057,504,1195,834,3,0,330
IMG_3326.MOV,617,1057,504,1195,836,3,0,332
IMG_3326.MOV,618,1057,506,1195,837,3,0,331
IMG_3326.MOV,619,1058,507,1195,837,3,0,330
IMG_3326.MOV,620,1056,508,1194,840,3,0,332
IMG_3326.MOV,621,1066,507,1203,844,3,0,337
IMG_3326.MOV,622,1074,508,1208,845,3,0,337
IMG_3326.MOV,623,1078,508,1210,846,3,0,338
IMG_3326.MOV,624,1083,510,1212,845,3,0,335
IMG_3326.MOV,625,1087,507,1215,845,3,0,338
IMG_3326.MOV,626,1091,505,1217,847,3,0,342
IMG_3326.MOV,627,1093,503,1218,848,3,0,345
IMG_3326.MOV,628,1096,501,1221,848,3,0,347
IMG_3326.MOV,629,1093,501,1220,850,3,0,349
IMG_3326.MOV,630,1092,502,1221,853,3,0,351
IMG_3326.MOV,631,1097,501,1227,854,3,0,353
IMG_3326.MOV,632,1102,502,1231,851,3,0,349
IMG_3326.MOV,633,1104,503,1233,850,3,0,347
IMG_3326.MOV,634,1120,507,1244,843,3,0,336
IMG_3326.MOV,635,1127,509,1250,839,3,0,330
IMG_3326.MOV,636,1130,507,1256,841,3,0,334
IMG_3326.MOV,637,1132,510,1255,836,3,0,326
IMG_3326.MOV,638,1133,511,1258,835,3,0,324
IMG_3326.MOV,639,1133,510,1260,834,3,0,324
IMG_3326.MOV,640,1135,510,1264,833,3,0,323
IMG_3326.MOV,641,1137,510,1268,834,3,0,324
IMG_3326.MOV,642,1145,513,1278,837,3,0,324
IMG_3326.MOV,643,1150,514,1285,840,3,0,326
IMG_3326.MOV,644,1152,514,1290,841,3,0,327
IMG_3326.MOV,645,1153,514,1295,843,3,0,329
IMG_3326.MOV,646,1154,512,1297,845,3,0,333
IMG_3326.MOV,647,1155,513,1299,845,3,0,332
IMG_3326.MOV,648,1156,513,1302,846,3,0,333
IMG_3326.MOV,1,678,419,753,669,4,0,250
IMG_3326.MOV,2,679,412,752,657,4,0,245
IMG_3326.MOV,3,680,411,752,653,4,0,242
IMG_3326.MOV,4,679,409,751,652,4,0,243
IMG_3326.MOV,5,679,409,751,653,4,0,244
IMG_3326.MOV,6,678,409,750,651,4,0,242
IMG_3326.MOV,7,678,411,749,649,4,0,238
IMG_3326.MOV,8,677,411,747,647,4,0,236
IMG_3326.MOV,9,675,412,746,645,4,0,233
IMG_3326.MOV,10,674,411,744,642,4,0,231
IMG_3326.MOV,11,672,411,743,643,4,0,232
IMG_3326.MOV,12,671,410,743,643,4,0,233
IMG_3326.MOV,13,671,410,743,644,4,0,234
IMG_3326.MOV,14,670,409,743,645,4,0,236
IMG_3326.MOV,15,670,408,743,646,4,0,238
IMG_3326.MOV,16,669,408,743,648,4,0,240
IMG_3326.MOV,17,669,409,742,648,4,0,239
IMG_3326.MOV,18,665,407,739,648,4,0,241
IMG_3326.MOV,19,664,406,737,648,4,0,242
IMG_3326.MOV,20,664,406,736,648,4,0,242
IMG_3326.MOV,21,663,407,735,646,4,0,239
IMG_3326.MOV,22,660,408,732,648,4,0,240
IMG_3326.MOV,23,659,408,730,647,4,0,239
IMG_3326.MOV,24,658,410,728,646,4,0,236
IMG_3326.MOV,25,657,412,726,644,4,0,232
IMG_3326.MOV,26,656,414,726,643,4,0,229
IMG_3326.MOV,27,656,415,725,642,4,0,227
IMG_3326.MOV,28,656,417,725,641,4,0,224
IMG_3326.MOV,29,656,418,725,639,4,0,221
IMG_3326.MOV,30,655,418,725,639,4,0,221
IMG_3326.MOV,31,654,418,725,639,4,0,221
IMG_3326.MOV,32,653,418,723,636,4,0,218
IMG_3326.MOV,33,651,419,721,636,4,0,217
IMG_3326.MOV,34,649,419,719,633,4,0,214
IMG_3326.MOV,35,648,419,717,632,4,0,213
IMG_3326.MOV,36,647,420,716,631,4,0,211
IMG_3326.MOV,37,645,420,715,632,4,0,212
IMG_3326.MOV,38,644,419,715,633,4,0,214
IMG_3326.MOV,39,643,417,714,633,4,0,216
IMG_3326.MOV,40,640,415,713,634,4,0,219
IMG_3326.MOV,41,638,413,712,637,4,0,224
IMG_3326.MOV,42,637,412,712,638,4,0,226
IMG_3326.MOV,43,636,412,711,636,4,0,224
IMG_3326.MOV,44,636,411,710,636,4,0,225
IMG_3326.MOV,45,635,411,710,639,4,0,228
IMG_3326.MOV,46,635,412,710,638,4,0,226
IMG_3326.MOV,47,633,412,708,637,4,0,225
IMG_3326.MOV,48,633,411,707,636,4,0,225
IMG_3326.MOV,49,632,411,706,635,4,0,224
IMG_3326.MOV,50,632,411,706,634,4,0,223
IMG_3326.MOV,51,631,411,705,635,4,0,224
IMG_3326.MOV,52,625,411,698,633,4,0,222
IMG_3326.MOV,53,622,411,696,634,4,0,223
IMG_3326.MOV,54,621,412,695,634,4,0,222
IMG_3326.MOV,55,621,413,694,634,4,0,221
IMG_3326.MOV,56,620,413,693,633,4,0,220
IMG_3326.MOV,57,620,413,692,633,4,0,220
IMG_3326.MOV,58,619,414,690,632,4,0,218
IMG_3326.MOV,59,619,416,689,632,4,0,216
IMG_3326.MOV,60,618,416,688,632,4,0,216
IMG_3326.MOV,61,618,417,687,631,4,0,214
IMG_3326.MOV,62,616,418,686,631,4,0,213
IMG_3326.MOV,63,616,418,686,633,4,0,215
IMG_3326.MOV,64,615,416,686,635,4,0,219
IMG_3326.MOV,65,615,416,686,635,4,0,219
IMG_3326.MOV,66,615,416,685,631,4,0,215
IMG_3326.MOV,67,616,416,684,628,4,0,212
IMG_3326.MOV,68,615,416,684,627,4,0,211
IMG_3326.MOV,69,614,416,683,626,4,0,210
IMG_3326.MOV,70,613,416,682,625,4,0,209
IMG_3326.MOV,71,612,414,682,625,4,0,211
IMG_3326.MOV,72,611,414,682,628,4,0,214
IMG_3326.MOV,73,611,413,681,627,4,0,214
IMG_3326.MOV,74,610,413,680,624,4,0,211
IMG_3326.MOV,75,610,412,679,623,4,0,211
IMG_3326.MOV,76,608,412,677,624,4,0,212
IMG_3326.MOV,77,607,411,677,625,4,0,214
IMG_3326.MOV,78,607,411,676,625,4,0,214
IMG_3326.MOV,79,606,411,675,625,4,0,214
IMG_3326.MOV,80,605,411,674,625,4,0,214
IMG_3326.MOV,81,603,411,673,626,4,0,215
IMG_3326.MOV,82,603,410,672,626,4,0,216
IMG_3326.MOV,83,602,410,671,626,4,0,216
IMG_3326.MOV,84,601,409,670,625,4,0,216
IMG_3326.MOV,85,600,409,669,625,4,0,216
IMG_3326.MOV,86,599,409,668,624,4,0,215
IMG_3326.MOV,87,599,409,669,624,4,0,215
IMG_3326.MOV,88,598,408,668,623,4,0,215
IMG_3326.MOV,89,598,408,667,622,4,0,214
IMG_3326.MOV,90,598,408,667,622,4,0,214
IMG_3326.MOV,91,597,409,666,621,4,0,212
IMG_3326.MOV,92,597,408,667,621,4,0,213
IMG_3326.MOV,93,597,408,667,621,4,0,213
IMG_3326.MOV,94,595,415,662,614,4,0,199
IMG_3326.MOV,95,588,412,657,617,4,0,205
IMG_3326.MOV,96,585,412,655,618,4,0,206
IMG_3326.MOV,97,587,416,656,615,4,0,199
IMG_3326.MOV,98,582,412,654,616,4,0,204
IMG_3326.MOV,99,579,413,651,618,4,0,205
IMG_3326.MOV,100,577,413,649,617,4,0,204
IMG_3326.MOV,101,574,414,647,617,4,0,203
IMG_3326.MOV,102,574,413,645,617,4,0,204
IMG_3326.MOV,103,572,413,643,616,4,0,203
IMG_3326.MOV,104,571,413,642,615,4,0,202
IMG_3326.MOV,105,571,414,641,616,4,0,202
IMG_3326.MOV,106,570,414,639,616,4,0,202
IMG_3326.MOV,107,569,413,638,616,4,0,203
IMG_3326.MOV,108,569,413,637,615,4,0,202
IMG_3326.MOV,109,568,412,637,615,4,0,203
IMG_3326.MOV,110,568,411,636,614,4,0,203
IMG_3326.MOV,111,567,412,634,613,4,0,201
IMG_3326.MOV,112,566,412,633,613,4,0,201
IMG_3326.MOV,113,565,412,631,615,4,0,203
IMG_3326.MOV,114,564,413,630,615,4,0,202
IMG_3326.MOV,115,563,413,629,615,4,0,202
IMG_3326.MOV,116,563,415,629,615,4,0,200
IMG_3326.MOV,117,563,415,629,615,4,0,200
IMG_3326.MOV,118,563,416,628,614,4,0,198
IMG_3326.MOV,119,563,418,627,614,4,0,196
IMG_3326.MOV,120,562,418,627,614,4,0,196
IMG_3326.MOV,121,561,417,627,614,4,0,197
IMG_3326.MOV,122,554,417,620,614,4,0,197
IMG_3326.MOV,123,552,417,617,612,4,0,195
IMG_3326.MOV,124,551,417,616,612,4,0,195
IMG_3326.MOV,125,550,417,615,611,4,0,194
IMG_3326.MOV,126,549,417,614,610,4,0,193
IMG_3326.MOV,127,548,416,613,611,4,0,195
IMG_3326.MOV,128,548,416,613,610,4,0,194
IMG_3326.MOV,129,548,416,612,610,4,0,194
IMG_3326.MOV,130,548,416,612,609,4,0,193
IMG_3326.MOV,131,547,415,610,606,4,0,191
IMG_3326.MOV,132,546,415,609,605,4,0,190
IMG_3326.MOV,133,545,415,608,606,4,0,191
IMG_3326.MOV,134,544,415,606,603,4,0,188
IMG_3326.MOV,135,544,416,605,601,4,0,185
IMG_3326.MOV,136,543,416,605,601,4,0,185
IMG_3326.MOV,137,541,414,605,604,4,0,190
IMG_3326.MOV,138,541,411,605,605,4,0,194
IMG_3326.MOV,139,541,411,605,605,4,0,194
IMG_3326.MOV,140,539,410,604,606,4,0,196
IMG_3326.MOV,141,539,410,603,605,4,0,195
IMG_3326.MOV,142,539,411,602,605,4,0,194
IMG_3326.MOV,143,538,412,600,604,4,0,192
IMG_3326.MOV,144,538,412,600,603,4,0,191
IMG_3326.MOV,145,538,412,599,603,4,0,191
IMG_3326.MOV,146,537,413,598,602,4,0,189
IMG_3326.MOV,147,536,413,596,602,4,0,189
IMG_3326.MOV,148,536,414,596,601,4,0,187
IMG_3326.MOV,149,536,415,596,602,4,0,187
IMG_3326.MOV,150,536,415,595,602,4,0,187
IMG_3326.MOV,151,534,415,594,604,4,0,189
IMG_3326.MOV,152,533,405,594,596,4,0,191
IMG_3326.MOV,153,532,409,594,603,4,0,194
IMG_3326.MOV,154,532,403,594,594,4,0,191
IMG_3326.MOV,155,532,401,593,589,4,0,188
IMG_3326.MOV,156,531,400,591,586,4,0,186
IMG_3326.MOV,157,530,401,588,583,4,0,182
IMG_3326.MOV,158,531,403,586,576,4,0,173
IMG_3326.MOV,159,531,404,584,571,4,0,167
IMG_3326.MOV,160,532,404,583,567,4,0,163
IMG_3326.MOV,161,531,404,582,564,4,1,160
IMG_3326.MOV,1,497,441,560,665,5,0,224
IMG_3326.MOV,2,497,440,559,665,5,0,225
IMG_3326.MOV,3,497,440,560,665,5,0,225
IMG_3326.MOV,4,496,439,559,665,5,0,226
IMG_3326.MOV,5,497,438,560,665,5,0,227
IMG_3326.MOV,6,497,437,560,666,5,0,229
IMG_3326.MOV,7,496,437,560,666,5,0,229
IMG_3326.MOV,8,496,436,560,667,5,0,231
IMG_3326.MOV,9,496,436,561,668,5,0,232
IMG_3326.MOV,10,496,434,561,670,5,0,236
IMG_3326.MOV,11,496,432,562,670,5,0,238
IMG_3326.MOV,12,496,433,563,669,5,0,236
IMG_3326.MOV,13,495,432,563,670,5,0,238
IMG_3326.MOV,14,494,430,564,671,5,0,241
IMG_3326.MOV,15,494,430,564,671,5,0,241
IMG_3326.MOV,16,494,431,565,672,5,0,241
IMG_3326.MOV,17,493,431,565,672,5,0,241
IMG_3326.MOV,18,492,431,565,673,5,0,242
IMG_3326.MOV,19,493,433,566,673,5,0,240
IMG_3326.MOV,20,493,434,566,671,5,0,237
IMG_3326.MOV,21,492,434,566,670,5,0,236
IMG_3326.MOV,22,491,433,565,670,5,0,237
IMG_3326.MOV,23,492,432,565,671,5,0,239
IMG_3326.MOV,24,492,434,564,671,5,0,237
IMG_3326.MOV,25,492,434,564,672,5,0,238
IMG_3326.MOV,26,493,434,564,672,5,0,238
IMG_3326.MOV,27,494,433,565,670,5,0,237
IMG_3326.MOV,28,494,432,565,669,5,0,237
IMG_3326.MOV,29,493,432,564,668,5,0,236
IMG_3326.MOV,30,493,433,563,668,5,0,235
IMG_3326.MOV,31,493,434,562,667,5,0,233
IMG_3326.MOV,32,493,433,562,668,5,0,235
IMG_3326.MOV,33,493,432,562,668,5,0,236
IMG_3326.MOV,34,493,430,563,669,5,0,239
IMG_3326.MOV,35,492,429,563,669,5,0,240
IMG_3326.MOV,36,492,430,563,669,5,0,239
IMG_3326.MOV,37,491,430,563,670,5,0,240
IMG_3326.MOV,38,490,430,563,670,5,0,240
IMG_3326.MOV,39,491,430,564,671,5,0,241
IMG_3326.MOV,40,490,431,564,671,5,0,240
IMG_3326.MOV,41,489,432,563,672,5,0,240
IMG_3326.MOV,42,489,433,563,672,5,0,239
IMG_3326.MOV,43,488,433,563,673,5,0,240
IMG_3326.MOV,44,487,433,563,673,5,0,240
IMG_3326.MOV,45,487,434,563,673,5,0,239
IMG_3326.MOV,46,487,434,563,674,5,0,240
IMG_3326.MOV,47,487,435,563,674,5,0,239
IMG_3326.MOV,48,487,436,563,674,5,0,238
IMG_3326.MOV,49,487,438,563,673,5,0,235
IMG_3326.MOV,50,487,439,562,673,5,0,234
IMG_3326.MOV,51,488,441,563,673,5,0,232
IMG_3326.MOV,52,488,442,562,673,5,0,231
IMG_3326.MOV,53,487,443,562,673,5,0,230
IMG_3326.MOV,54,487,444,562,673,5,0,229
IMG_3326.MOV,55,488,444,562,673,5,0,229
IMG_3326.MOV,56,488,444,562,673,5,0,229
IMG_3326.MOV,57,487,443,562,674,5,0,231
IMG_3326.MOV,58,487,443,561,674,5,0,231
IMG_3326.MOV,59,486,444,561,674,5,0,230
IMG_3326.MOV,60,487,445,561,674,5,0,229
IMG_3326.MOV,61,487,445,562,675,5,0,230
IMG_3326.MOV,62,488,445,563,674,5,0,229
IMG_3326.MOV,63,489,446,563,674,5,0,228
IMG_3326.MOV,64,489,447,563,674,5,0,227
IMG_3326.MOV,65,489,447,564,675,5,0,228
IMG_3326.MOV,66,490,447,564,676,5,0,229
IMG_3326.MOV,67,491,445,565,676,5,0,231
IMG_3326.MOV,68,491,446,565,677,5,0,231
IMG_3326.MOV,69,491,445,565,676,5,0,231
IMG_3326.MOV,70,491,445,565,676,5,0,231
IMG_3326.MOV,71,491,444,564,677,5,0,233
IMG_3326.MOV,72,491,444,565,677,5,0,233
IMG_3326.MOV,73,491,444,564,677,5,0,233
IMG_3326.MOV,74,491,444,564,676,5,0,232
IMG_3326.MOV,75,491,444,564,679,5,0,235
IMG_3326.MOV,76,490,444,563,680,5,0,236
IMG_3326.MOV,77,489,444,563,681,5,0,237
IMG_3326.MOV,78,490,444,563,679,5,0,235
IMG_3326.MOV,79,491,444,563,679,5,0,235
IMG_3326.MOV,80,491,444,562,679,5,0,235
IMG_3326.MOV,81,491,443,562,679,5,0,236
IMG_3326.MOV,82,491,443,562,679,5,0,236
IMG_3326.MOV,83,492,444,562,679,5,0,235
IMG_3326.MOV,84,493,444,562,678,5,0,234
IMG_3326.MOV,85,493,444,562,678,5,0,234
IMG_3326.MOV,86,493,444,563,678,5,0,234
IMG_3326.MOV,87,491,443,563,682,5,0,239
IMG_3326.MOV,88,491,442,563,683,5,0,241
IMG_3326.MOV,89,494,444,565,680,5,0,236
IMG_3326.MOV,90,495,446,565,680,5,0,234
IMG_3326.MOV,91,494,446,564,680,5,0,234
IMG_3326.MOV,92,494,446,564,680,5,0,234
IMG_3326.MOV,93,493,445,564,681,5,0,236
IMG_3326.MOV,94,492,444,563,682,5,0,238
IMG_3326.MOV,95,491,443,563,683,5,0,240
IMG_3326.MOV,96,490,443,562,683,5,0,240
IMG_3326.MOV,97,490,443,562,684,5,0,241
IMG_3326.MOV,98,491,443,563,684,5,0,241
IMG_3326.MOV,99,491,444,563,683,5,0,239
IMG_3326.MOV,100,491,444,562,681,5,0,237
IMG_3326.MOV,101,492,444,563,681,5,0,237
IMG_3326.MOV,102,491,443,563,681,5,0,238
IMG_3326.MOV,103,491,443,563,682,5,0,239
IMG_3326.MOV,104,491,444,563,682,5,0,238
IMG_3326.MOV,105,492,446,563,682,5,0,236
IMG_3326.MOV,106,492,448,564,683,5,0,235
IMG_3326.MOV,107,492,449,563,683,5,0,234
IMG_3326.MOV,108,492,450,564,683,5,0,233
IMG_3326.MOV,109,493,451,564,683,5,0,232
IMG_3326.MOV,110,493,452,564,683,5,0,231
IMG_3326.MOV,111,493,453,564,682,5,0,229
IMG_3326.MOV,112,493,453,564,682,5,0,229
IMG_3326.MOV,113,492,452,564,682,5,0,230
IMG_3326.MOV,114,492,453,564,682,5,0,229
IMG_3326.MOV,115,491,454,563,682,5,0,228
IMG_3326.MOV,116,491,455,564,681,5,0,226
IMG_3326.MOV,117,490,455,563,681,5,0,226
IMG_3326.MOV,118,489,456,562,680,5,0,224
IMG_3326.MOV,119,489,456,561,678,5,0,222
IMG_3326.MOV,120,489,458,561,678,5,0,220
IMG_3326.MOV,121,489,459,561,677,5,0,218
IMG_3326.MOV,122,489,460,561,675,5,0,215
IMG_3326.MOV,123,489,461,561,675,5,0,214
IMG_3326.MOV,124,488,461,561,675,5,0,214
IMG_3326.MOV,125,488,462,561,675,5,0,213
IMG_3326.MOV,126,488,462,562,674,5,0,212
IMG_3326.MOV,127,488,460,562,674,5,0,214
IMG_3326.MOV,128,487,455,564,678,5,0,223
IMG_3326.MOV,129,486,453,564,680,5,0,227
IMG_3326.MOV,130,487,457,563,678,5,0,221
IMG_3326.MOV,131,486,459,562,676,5,0,217
IMG_3326.MOV,132,486,460,562,676,5,0,216
IMG_3326.MOV,133,486,455,564,680,5,0,225
IMG_3326.MOV,134,487,460,563,676,5,0,216
IMG_3326.MOV,135,487,462,563,675,5,0,213
IMG_3326.MOV,136,487,463,564,675,5,0,212
IMG_3326.MOV,137,486,463,563,675,5,0,212
IMG_3326.MOV,138,485,463,563,675,5,0,212
IMG_3326.MOV,139,485,463,564,675,5,0,212
IMG_3326.MOV,140,485,458,566,678,5,0,220
IMG_3326.MOV,141,485,456,567,678,5,0,222
IMG_3326.MOV,142,485,456,567,678,5,0,222
IMG_3326.MOV,143,485,458,566,678,5,0,220
IMG_3326.MOV,144,485,460,566,678,5,0,218
IMG_3326.MOV,145,485,460,566,677,5,0,217
IMG_3326.MOV,146,485,461,566,677,5,0,216
IMG_3326.MOV,147,485,461,567,678,5,0,217
IMG_3326.MOV,148,485,462,567,678,5,0,216
IMG_3326.MOV,149,485,461,568,678,5,0,217
IMG_3326.MOV,150,485,461,567,677,5,0,216
IMG_3326.MOV,151,485,461,568,677,5,0,216
IMG_3326.MOV,152,486,462,569,676,5,0,214
IMG_3326.MOV,153,486,462,569,676,5,0,214
IMG_3326.MOV,154,486,462,569,676,5,0,214
IMG_3326.MOV,155,485,462,569,677,5,0,215
IMG_3326.MOV,156,485,461,569,678,5,0,217
IMG_3326.MOV,157,485,460,569,679,5,0,219
IMG_3326.MOV,158,484,460,568,680,5,0,220
IMG_3326.MOV,159,483,459,568,681,5,0,222
IMG_3326.MOV,160,484,459,569,681,5,0,222
IMG_3326.MOV,161,484,458,569,681,5,0,223
IMG_3326.MOV,162,484,458,569,682,5,0,224
IMG_3326.MOV,163,485,459,569,681,5,0,222
IMG_3326.MOV,164,485,459,569,681,5,0,222
IMG_3326.MOV,165,486,459,570,682,5,0,223
IMG_3326.MOV,166,485,459,570,682,5,0,223
IMG_3326.MOV,167,486,460,570,682,5,0,222
IMG_3326.MOV,168,487,463,570,681,5,0,218
IMG_3326.MOV,169,487,463,570,681,5,0,218
IMG_3326.MOV,170,488,464,570,680,5,0,216
IMG_3326.MOV,171,488,465,570,680,5,0,215
IMG_3326.MOV,172,487,465,570,680,5,0,215
IMG_3326.MOV,173,488,464,570,680,5,0,216
IMG_3326.MOV,174,488,464,570,681,5,0,217
IMG_3326.MOV,175,488,463,571,681,5,0,218
IMG_3326.MOV,176,488,462,571,681,5,0,219
IMG_3326.MOV,177,489,462,572,681,5,0,219
IMG_3326.MOV,178,488,462,571,680,5,0,218
IMG_3326.MOV,179,488,462,572,680,5,0,218
IMG_3326.MOV,180,489,464,571,680,5,0,216
IMG_3326.MOV,181,489,466,571,680,5,0,214
IMG_3326.MOV,182,488,464,571,682,5,0,218
IMG_3326.MOV,183,487,464,571,682,5,0,218
IMG_3326.MOV,184,487,464,570,682,5,0,218
IMG_3326.MOV,185,487,465,570,682,5,0,217
IMG_3326.MOV,186,487,467,569,682,5,0,215
IMG_3326.MOV,187,485,468,569,683,5,0,215
IMG_3326.MOV,188,485,466,569,683,5,0,217
IMG_3326.MOV,189,484,465,570,684,5,0,219
IMG_3326.MOV,190,484,464,570,684,5,0,220
IMG_3326.MOV,191,484,463,570,684,5,0,221
IMG_3326.MOV,192,483,461,570,684,5,0,223
IMG_3326.MOV,193,483,461,570,684,5,0,223
IMG_3326.MOV,194,484,463,570,684,5,0,221
IMG_3326.MOV,195,484,461,570,684,5,0,223
IMG_3326.MOV,196,484,460,570,684,5,0,224
IMG_3326.MOV,197,484,460,571,684,5,0,224
IMG_3326.MOV,198,484,460,570,684,5,0,224
IMG_3326.MOV,199,484,459,570,683,5,0,224
IMG_3326.MOV,200,484,459,570,683,5,0,224
IMG_3326.MOV,201,485,459,570,683,5,0,224
IMG_3326.MOV,202,485,458,570,683,5,0,225
IMG_3326.MOV,203,484,458,570,684,5,0,226
IMG_3326.MOV,204,484,458,569,683,5,0,225
IMG_3326.MOV,205,483,458,568,683,5,0,225
IMG_3326.MOV,206,484,460,568,683,5,0,223
IMG_3326.MOV,207,484,461,568,682,5,0,221
IMG_3326.MOV,208,485,461,568,682,5,0,221
IMG_3326.MOV,209,484,460,568,682,5,0,222
IMG_3326.MOV,210,484,459,568,683,5,0,224
IMG_3326.MOV,211,485,459,568,683,5,0,224
IMG_3326.MOV,212,485,459,568,683,5,0,224
IMG_3326.MOV,213,485,459,568,684,5,0,225
IMG_3326.MOV,214,485,458,567,684,5,0,226
IMG_3326.MOV,215,484,457,567,684,5,0,227
IMG_3326.MOV,216,484,457,567,684,5,0,227
IMG_3326.MOV,217,485,457,567,685,5,0,228
IMG_3326.MOV,218,485,457,567,685,5,0,228
IMG_3326.MOV,219,486,456,567,685,5,0,229
IMG_3326.MOV,220,485,455,567,685,5,0,230
IMG_3326.MOV,221,485,453,566,682,5,0,229
IMG_3326.MOV,222,485,453,565,682,5,0,229
IMG_3326.MOV,223,485,452,565,681,5,0,229
IMG_3326.MOV,224,485,452,565,682,5,0,230
IMG_3326.MOV,225,486,452,565,682,5,0,230
IMG_3326.MOV,226,485,452,564,682,5,0,230
IMG_3326.MOV,227,485,452,564,682,5,0,230
IMG_3326.MOV,228,485,451,564,682,5,0,231
IMG_3326.MOV,229,486,451,564,683,5,0,232
IMG_3326.MOV,230,486,451,564,682,5,0,231
IMG_3326.MOV,231,486,451,564,682,5,0,231
IMG_3326.MOV,232,486,453,564,683,5,0,230
IMG_3326.MOV,233,486,451,563,682,5,0,231
IMG_3326.MOV,234,486,453,564,683,5,0,230
IMG_3326.MOV,235,486,453,564,683,5,0,230
IMG_3326.MOV,236,487,454,565,683,5,0,229
IMG_3326.MOV,237,487,454,565,683,5,0,229
IMG_3326.MOV,238,487,453,565,683,5,0,230
IMG_3326.MOV,239,487,452,566,683,5,0,231
IMG_3326.MOV,240,488,452,565,683,5,0,231
IMG_3326.MOV,241,488,452,565,683,5,0,231
IMG_3326.MOV,242,488,452,565,683,5,0,231
IMG_3326.MOV,243,487,452,565,684,5,0,232
IMG_3326.MOV,244,489,452,565,682,5,0,230
IMG_3326.MOV,245,489,451,564,682,5,0,231
IMG_3326.MOV,246,489,452,564,682,5,0,230
IMG_3326.MOV,247,489,452,563,681,5,0,229
IMG_3326.MOV,248,490,452,563,681,5,0,229
IMG_3326.MOV,249,491,452,563,681,5,0,229
IMG_3326.MOV,250,490,452,563,681,5,0,229
IMG_3326.MOV,251,490,451,562,681,5,0,230
IMG_3326.MOV,252,490,451,562,681,5,0,230
IMG_3326.MOV,253,490,450,562,681,5,0,231
IMG_3326.MOV,254,489,449,562,682,5,0,233
IMG_3326.MOV,255,489,449,561,682,5,0,233
IMG_3326.MOV,256,487,445,561,684,5,0,239
IMG_3326.MOV,257,486,446,561,684,5,0,238
IMG_3326.MOV,258,486,447,561,684,5,0,237
IMG_3326.MOV,259,487,449,561,683,5,0,234
IMG_3326.MOV,260,473,443,552,685,5,0,242
IMG_3326.MOV,261,481,447,559,683,5,0,236
IMG_3326.MOV,262,471,446,551,685,5,0,239
IMG_3326.MOV,263,465,443,549,689,5,0,246
IMG_3326.MOV,264,476,446,558,685,5,0,239
IMG_3326.MOV,265,483,450,562,682,5,0,232
IMG_3326.MOV,266,469,443,554,692,5,0,249
IMG_3326.MOV,267,477,446,560,688,5,0,242
IMG_3326.MOV,268,482,448,562,685,5,0,237
IMG_3326.MOV,269,483,446,564,685,5,0,239
IMG_3326.MOV,270,483,446,564,684,5,0,238
IMG_3326.MOV,271,484,445,564,684,5,0,239
IMG_3326.MOV,272,485,447,564,684,5,0,237
IMG_3326.MOV,273,486,448,564,683,5,0,235
IMG_3326.MOV,274,488,450,565,683,5,0,233
IMG_3326.MOV,275,487,452,564,683,5,0,231
IMG_3326.MOV,276,486,450,563,683,5,0,233
IMG_3326.MOV,277,485,444,565,685,5,0,241
IMG_3326.MOV,278,486,442,566,685,5,0,243
IMG_3326.MOV,279,488,445,566,683,5,0,238
IMG_3326.MOV,280,489,447,566,682,5,0,235
IMG_3326.MOV,281,490,451,566,682,5,0,231
IMG_3326.MOV,282,491,450,567,682,5,0,232
IMG_3326.MOV,283,492,451,567,680,5,0,229
IMG_3326.MOV,284,492,451,568,680,5,0,229
IMG_3326.MOV,285,493,452,568,681,5,0,229
IMG_3326.MOV,286,492,452,568,682,5,0,230
IMG_3326.MOV,287,493,452,568,680,5,0,228
IMG_3326.MOV,288,493,452,568,679,5,0,227
IMG_3326.MOV,289,493,453,568,680,5,0,227
IMG_3326.MOV,290,493,451,569,679,5,0,228
IMG_3326.MOV,291,493,450,569,678,5,0,228
IMG_3326.MOV,292,493,448,569,676,5,0,228
IMG_3326.MOV,293,494,450,569,675,5,0,225
IMG_3326.MOV,294,493,450,567,674,5,0,224
IMG_3326.MOV,295,493,452,567,672,5,0,220
IMG_3326.MOV,296,493,452,565,671,5,0,219
IMG_3326.MOV,297,493,451,565,670,5,0,219
IMG_3326.MOV,298,493,453,564,668,5,0,215
IMG_3326.MOV,299,493,448,565,665,5,0,217
IMG_3326.MOV,300,493,447,565,665,5,0,218
IMG_3326.MOV,301,493,448,565,664,5,0,216
IMG_3326.MOV,302,493,447,566,666,5,0,219
IMG_3326.MOV,303,491,447,566,675,5,0,228
IMG_3326.MOV,304,491,446,566,678,5,0,232
IMG_3326.MOV,305,492,447,565,679,5,0,232
IMG_3326.MOV,306,492,445,565,679,5,0,234
IMG_3326.MOV,307,492,445,565,679,5,0,234
IMG_3326.MOV,308,493,445,565,679,5,0,234
IMG_3326.MOV,309,494,445,565,680,5,0,235
IMG_3326.MOV,310,494,444,565,680,5,0,236
IMG_3326.MOV,311,494,444,565,681,5,0,237
IMG_3326.MOV,312,495,445,565,680,5,0,235
IMG_3326.MOV,313,495,446,564,680,5,0,234
IMG_3326.MOV,314,495,446,564,680,5,1,234
IMG_3326.MOV,1,288,406,359,573,6,0,167
IMG_3326.MOV,2,288,406,359,573,6,0,167
IMG_3326.MOV,3,288,406,359,572,6,0,166
IMG_3326.MOV,4,288,406,359,572,6,0,166
IMG_3326.MOV,5,288,406,358,573,6,0,167
IMG_3326.MOV,6,288,407,358,573,6,0,166
IMG_3326.MOV,7,288,407,358,573,6,0,166
IMG_3326.MOV,8,288,407,357,573,6,0,166
IMG_3326.MOV,9,288,406,357,573,6,0,167
IMG_3326.MOV,10,288,406,356,572,6,0,166
IMG_3326.MOV,11,288,405,356,572,6,0,167
IMG_3326.MOV,12,288,405,356,571,6,0,166
IMG_3326.MOV,13,288,405,356,571,6,0,166
IMG_3326.MOV,14,289,405,356,568,6,0,163
IMG_3326.MOV,15,290,406,356,568,6,0,162
IMG_3326.MOV,16,291,406,356,567,6,0,161
IMG_3326.MOV,17,290,406,357,567,6,0,161
IMG_3326.MOV,18,291,406,357,568,6,0,162
IMG_3326.MOV,19,290,405,358,568,6,0,163
IMG_3326.MOV,20,291,405,358,568,6,0,163
IMG_3326.MOV,21,290,406,357,568,6,0,162
IMG_3326.MOV,22,291,406,357,568,6,0,162
IMG_3326.MOV,23,290,407,357,568,6,0,161
IMG_3326.MOV,24,290,408,357,568,6,0,160
IMG_3326.MOV,25,291,408,357,568,6,0,160
IMG_3326.MOV,26,291,408,357,567,6,0,159
IMG_3326.MOV,27,291,408,358,568,6,0,160
IMG_3326.MOV,28,290,408,358,568,6,0,160
IMG_3326.MOV,29,290,408,358,568,6,0,160
IMG_3326.MOV,30,300,410,368,568,6,0,158
IMG_3326.MOV,31,303,411,372,568,6,0,157
IMG_3326.MOV,32,304,411,373,568,6,0,157
IMG_3326.MOV,33,305,412,374,567,6,0,155
IMG_3326.MOV,34,295,410,365,569,6,0,159
IMG_3326.MOV,35,290,408,362,570,6,0,162
IMG_3326.MOV,36,299,410,370,570,6,0,160
IMG_3326.MOV,37,301,411,373,572,6,0,161
IMG_3326.MOV,38,302,411,375,573,6,0,162
IMG_3326.MOV,39,303,410,376,574,6,0,164
IMG_3326.MOV,40,303,410,376,574,6,0,164
IMG_3326.MOV,41,304,410,377,574,6,0,164
IMG_3326.MOV,42,304,411,377,574,6,0,163
IMG_3326.MOV,43,305,412,377,574,6,0,162
IMG_3326.MOV,44,304,412,377,575,6,0,163
IMG_3326.MOV,45,304,412,377,576,6,0,164
IMG_3326.MOV,46,303,411,377,577,6,0,166
IMG_3326.MOV,47,303,411,376,578,6,0,167
IMG_3326.MOV,48,303,411,376,578,6,0,167
IMG_3326.MOV,49,303,411,376,579,6,0,168
IMG_3326.MOV,50,303,412,376,578,6,0,166
IMG_3326.MOV,51,303,412,374,577,6,0,165
IMG_3326.MOV,52,303,412,375,577,6,1,165
IMG_3326.MOV,1,1789,646,1927,1062,7,0,416
IMG_3326.MOV,2,1808,634,1919,967,7,0,333
IMG_3326.MOV,3,1800,636,1931,1037,7,0,401
IMG_3326.MOV,4,1797,635,1935,1060,7,0,425
IMG_3326.MOV,5,1796,635,1937,1075,7,0,440
IMG_3326.MOV,6,1794,637,1935,1082,7,0,445
IMG_3326.MOV,7,1792,638,1932,1086,7,0,448
IMG_3326.MOV,8,1778,566,1938,1089,7,0,523
IMG_3326.MOV,9,1788,617,1930,1085,7,0,468
IMG_3326.MOV,10,1776,551,1937,1088,7,0,537
IMG_3326.MOV,11,1772,529,1938,1091,7,0,562
IMG_3326.MOV,12,1770,517,1940,1096,7,1,579
IMG_3326.MOV,17,1777,515,1936,1070,7,0,555
IMG_3326.MOV,18,1779,517,1933,1063,7,0,546
IMG_3326.MOV,19,1782,517,1932,1060,7,0,543
IMG_3326.MOV,20,1790,517,1923,995,7,0,478
IMG_3326.MOV,21,1794,518,1918,965,7,0,447
IMG_3326.MOV,22,1795,518,1917,951,7,0,433
IMG_3326.MOV,23,1796,524,1915,943,7,0,419
IMG_3326.MOV,24,1795,526,1914,939,7,0,413
IMG_3326.MOV,25,1795,528,1914,935,7,0,407
IMG_3326.MOV,26,1795,529,1914,936,7,0,407
IMG_3326.MOV,27,1795,529,1915,937,7,0,408
IMG_3326.MOV,28,1796,528,1916,935,7,0,407
IMG_3326.MOV,29,1795,529,1916,935,7,0,406
IMG_3326.MOV,30,1795,529,1916,936,7,0,407
IMG_3326.MOV,31,1794,530,1916,936,7,0,406
IMG_3326.MOV,32,1794,530,1916,937,7,0,407
IMG_3326.MOV,33,1793,529,1916,938,7,0,409
IMG_3326.MOV,34,1793,528,1917,938,7,0,410
IMG_3326.MOV,35,1793,529,1917,937,7,0,408
IMG_3326.MOV,36,1792,529,1917,938,7,0,409
IMG_3326.MOV,37,1792,528,1918,938,7,0,410
IMG_3326.MOV,38,1793,527,1919,939,7,0,412
IMG_3326.MOV,39,1792,527,1919,940,7,0,413
IMG_3326.MOV,40,1792,527,1919,940,7,0,413
IMG_3326.MOV,41,1791,527,1919,941,7,0,414
IMG_3326.MOV,42,1791,526,1919,942,7,0,416
IMG_3326.MOV,43,1790,526,1920,943,7,0,417
IMG_3326.MOV,44,1790,526,1920,943,7,0,417
IMG_3326.MOV,45,1790,528,1920,944,7,0,416
IMG_3326.MOV,46,1790,528,1920,944,7,0,416
IMG_3326.MOV,47,1790,527,1920,944,7,0,417
IMG_3326.MOV,48,1790,527,1920,943,7,0,416
IMG_3326.MOV,49,1790,526,1920,942,7,0,416
IMG_3326.MOV,50,1791,534,1920,942,7,0,408
IMG_3326.MOV,51,1790,536,1919,944,7,0,408
IMG_3326.MOV,52,1789,536,1919,944,7,0,408
IMG_3326.MOV,53,1789,535,1920,946,7,0,411
IMG_3326.MOV,54,1789,534,1920,946,7,0,412
IMG_3326.MOV,55,1789,535,1921,946,7,0,411
IMG_3326.MOV,56,1790,536,1921,944,7,0,408
IMG_3326.MOV,57,1790,537,1920,942,7,0,405
IMG_3326.MOV,58,1790,538,1920,940,7,0,402
IMG_3326.MOV,59,1791,537,1921,939,7,0,402
IMG_3326.MOV,60,1791,538,1921,941,7,0,403
IMG_3326.MOV,61,1791,539,1921,940,7,0,401
IMG_3326.MOV,62,1792,540,1921,937,7,0,397
IMG_3326.MOV,63,1793,542,1921,937,7,0,395
IMG_3326.MOV,64,1793,543,1921,937,7,0,394
IMG_3326.MOV,65,1793,543,1922,937,7,0,394
IMG_3326.MOV,66,1793,543,1922,937,7,0,394
IMG_3326.MOV,67,1794,544,1922,936,7,0,392
IMG_3326.MOV,68,1794,545,1922,935,7,0,390
IMG_3326.MOV,69,1795,545,1922,935,7,0,390
IMG_3326.MOV,70,1795,543,1923,936,7,0,393
IMG_3326.MOV,71,1794,542,1923,938,7,0,396
IMG_3326.MOV,72,1794,542,1923,939,7,0,397
IMG_3326.MOV,73,1793,541,1923,942,7,0,401
IMG_3326.MOV,74,1794,540,1923,942,7,0,402
IMG_3326.MOV,75,1793,538,1923,944,7,0,406
IMG_3326.MOV,76,1793,538,1923,945,7,0,407
IMG_3326.MOV,77,1794,538,1924,945,7,0,407
IMG_3326.MOV,78,1794,537,1923,943,7,0,406
IMG_3326.MOV,79,1794,538,1923,944,7,0,406
IMG_3326.MOV,80,1795,538,1923,943,7,0,405
IMG_3326.MOV,81,1795,537,1923,943,7,0,406
IMG_3326.MOV,82,1794,537,1922,945,7,0,408
IMG_3326.MOV,83,1794,537,1922,946,7,0,409
IMG_3326.MOV,84,1795,537,1923,946,7,0,409
IMG_3326.MOV,85,1795,537,1923,945,7,0,408
IMG_3326.MOV,86,1795,538,1922,945,7,0,407
IMG_3326.MOV,87,1795,538,1922,945,7,0,407
IMG_3326.MOV,88,1796,540,1921,943,7,0,403
IMG_3326.MOV,89,1797,542,1921,942,7,0,400
IMG_3326.MOV,90,1797,544,1920,942,7,0,398
IMG_3326.MOV,91,1797,545,1920,941,7,0,396
IMG_3326.MOV,92,1798,546,1921,940,7,0,394
IMG_3326.MOV,93,1800,547,1921,939,7,0,392
IMG_3326.MOV,94,1800,548,1921,937,7,0,389
IMG_3326.MOV,95,1801,546,1922,938,7,0,392
IMG_3326.MOV,96,1800,544,1923,941,7,0,397
IMG_3326.MOV,97,1800,543,1923,943,7,0,400
IMG_3326.MOV,98,1799,541,1924,948,7,0,407
IMG_3326.MOV,99,1800,539,1925,951,7,0,412
IMG_3326.MOV,100,1801,537,1926,953,7,0,416
IMG_3326.MOV,101,1802,537,1926,954,7,0,417
IMG_3326.MOV,102,1803,537,1926,953,7,0,416
IMG_3326.MOV,103,1804,537,1925,952,7,0,415
IMG_3326.MOV,104,1804,537,1924,952,7,0,415
IMG_3326.MOV,105,1810,542,1923,937,7,0,395
IMG_3326.MOV,106,1807,539,1924,946,7,0,407
IMG_3326.MOV,107,1807,539,1923,948,7,0,409
IMG_3326.MOV,108,1806,541,1922,947,7,0,406
IMG_3326.MOV,109,1807,542,1922,948,7,0,406
IMG_3326.MOV,110,1807,544,1922,950,7,0,406
IMG_3326.MOV,111,1807,544,1922,953,7,0,409
IMG_3326.MOV,112,1808,547,1922,952,7,0,405
IMG_3326.MOV,113,1808,547,1922,953,7,0,406
IMG_3326.MOV,114,1809,548,1921,954,7,0,406
IMG_3326.MOV,115,1809,549,1921,955,7,0,406
IMG_3326.MOV,116,1809,550,1921,953,7,0,403
IMG_3326.MOV,117,1810,551,1921,952,7,0,401
IMG_3326.MOV,118,1811,552,1921,952,7,0,400
IMG_3326.MOV,119,1811,552,1921,951,7,0,399
IMG_3326.MOV,120,1812,552,1921,952,7,0,400
IMG_3326.MOV,121,1813,552,1921,952,7,0,400
IMG_3326.MOV,122,1813,552,1922,953,7,0,401
IMG_3326.MOV,123,1811,560,1921,965,7,0,405
IMG_3326.MOV,124,1813,554,1922,959,7,0,405
IMG_3326.MOV,125,1814,557,1924,971,7,0,414
IMG_3326.MOV,126,1814,552,1922,961,7,0,409
IMG_3326.MOV,127,1814,550,1922,957,7,0,407
IMG_3326.MOV,128,1814,549,1921,957,7,0,408
IMG_3326.MOV,129,1815,549,1922,957,7,0,408
IMG_3326.MOV,130,1816,548,1922,957,7,0,409
IMG_3326.MOV,131,1816,546,1923,958,7,0,412
IMG_3326.MOV,132,1816,546,1922,958,7,0,412
IMG_3326.MOV,133,1816,551,1925,976,7,0,425
IMG_3326.MOV,134,1817,547,1923,966,7,0,419
IMG_3326.MOV,135,1817,547,1922,961,7,0,414
IMG_3326.MOV,136,1818,551,1925,977,7,0,426
IMG_3326.MOV,137,1818,552,1926,985,7,0,433
IMG_3326.MOV,138,1819,553,1926,988,7,0,435
IMG_3326.MOV,139,1819,554,1926,991,7,0,437
IMG_3326.MOV,140,1821,555,1926,990,7,0,435
IMG_3326.MOV,141,1822,555,1926,991,7,0,436
IMG_3326.MOV,142,1824,558,1926,987,7,0,429
IMG_3326.MOV,143,1825,560,1925,982,7,0,422
IMG_3326.MOV,144,1826,562,1925,979,7,0,417
IMG_3326.MOV,145,1826,557,1921,959,7,0,402
IMG_3326.MOV,146,1829,555,1922,949,7,0,394
IMG_3326.MOV,147,1831,555,1922,944,7,0,389
IMG_3326.MOV,148,1828,557,1925,973,7,0,416
IMG_3326.MOV,149,1827,559,1924,980,7,0,421
IMG_3326.MOV,150,1827,561,1924,981,7,0,420
IMG_3326.MOV,151,1830,556,1923,960,7,0,404
IMG_3326.MOV,152,1832,554,1924,953,7,0,399
IMG_3326.MOV,153,1832,552,1924,951,7,0,399
IMG_3326.MOV,154,1832,551,1924,951,7,0,400
IMG_3326.MOV,155,1831,558,1924,967,7,0,409
IMG_3326.MOV,156,1830,563,1923,971,7,0,408
IMG_3326.MOV,157,1831,565,1924,973,7,0,408
IMG_3326.MOV,158,1832,566,1924,974,7,0,408
IMG_3326.MOV,159,1834,566,1925,974,7,0,408
IMG_3326.MOV,160,1836,557,1925,958,7,0,401
IMG_3326.MOV,161,1838,552,1926,954,7,0,402
IMG_3326.MOV,162,1837,557,1927,973,7,0,416
IMG_3326.MOV,163,1838,560,1927,981,7,0,421
IMG_3326.MOV,164,1840,562,1928,985,7,0,423
IMG_3326.MOV,165,1841,563,1928,987,7,0,424
IMG_3326.MOV,166,1843,563,1928,988,7,0,425
IMG_3326.MOV,167,1843,560,1928,992,7,0,432
IMG_3326.MOV,168,1845,558,1929,993,7,0,435
IMG_3326.MOV,169,1845,556,1928,994,7,0,438
IMG_3326.MOV,170,1845,552,1928,998,7,0,446
IMG_3326.MOV,171,1845,547,1928,1003,7,0,456
IMG_3326.MOV,172,1846,546,1928,1006,7,0,460
IMG_3326.MOV,173,1849,549,1929,1008,7,0,459
IMG_3326.MOV,174,1852,561,1927,1002,7,0,441
IMG_3326.MOV,175,1853,562,1928,1004,7,1,442
IMG_3326.MOV,179,1857,572,1929,1004,7,0,432
IMG_3326.MOV,180,1858,573,1929,1005,7,1,432
IMG_3326.MOV,1,84,445,156,607,8,0,162
IMG_3326.MOV,2,83,444,156,608,8,0,164
IMG_3326.MOV,3,82,443,156,610,8,0,167
IMG_3326.MOV,4,81,442,155,611,8,0,169
IMG_3326.MOV,5,82,441,156,611,8,0,170
IMG_3326.MOV,6,83,440,157,612,8,0,172
IMG_3326.MOV,7,84,440,157,612,8,0,172
IMG_3326.MOV,8,84,441,157,612,8,0,171
IMG_3326.MOV,9,86,442,156,610,8,0,168
IMG_3326.MOV,10,86,441,157,611,8,0,170
IMG_3326.MOV,11,88,442,157,610,8,0,168
IMG_3326.MOV,12,88,442,157,610,8,0,168
IMG_3326.MOV,13,91,443,160,610,8,0,167
IMG_3326.MOV,14,92,445,162,609,8,0,164
IMG_3326.MOV,15,92,447,162,609,8,0,162
IMG_3326.MOV,16,92,447,164,609,8,0,162
IMG_3326.MOV,17,91,448,165,611,8,0,163
IMG_3326.MOV,18,92,448,168,611,8,0,163
IMG_3326.MOV,19,92,447,169,611,8,0,164
IMG_3326.MOV,20,92,447,170,612,8,0,165
IMG_3326.MOV,21,92,447,171,613,8,0,166
IMG_3326.MOV,22,93,449,173,612,8,0,163
IMG_3326.MOV,23,91,448,172,613,8,0,165
IMG_3326.MOV,24,91,448,173,614,8,0,166
IMG_3326.MOV,25,90,446,174,615,8,0,169
IMG_3326.MOV,26,89,446,175,615,8,0,169
IMG_3326.MOV,27,89,448,174,614,8,0,166
IMG_3326.MOV,28,90,448,174,615,8,0,167
IMG_3326.MOV,29,92,448,176,615,8,0,167
IMG_3326.MOV,30,93,447,177,614,8,0,167
IMG_3326.MOV,31,94,447,177,610,8,0,163
IMG_3326.MOV,32,95,447,177,610,8,1,163
IMG_3326.MOV,42,110,458,196,631,8,0,173
IMG_3326.MOV,43,112,460,198,631,8,0,171
IMG_3326.MOV,44,113,461,198,630,8,0,169
IMG_3326.MOV,45,114,462,198,630,8,0,168
IMG_3326.MOV,46,115,463,199,629,8,0,166
IMG_3326.MOV,47,115,463,200,629,8,0,166
IMG_3326.MOV,48,115,462,200,629,8,0,167
IMG_3326.MOV,49,115,463,200,629,8,0,166
IMG_3326.MOV,50,117,463,200,629,8,0,166
IMG_3326.MOV,51,118,464,200,629,8,0,165
IMG_3326.MOV,52,118,465,199,629,8,0,164
IMG_3326.MOV,53,118,463,200,629,8,0,166
IMG_3326.MOV,54,118,463,199,630,8,0,167
IMG_3326.MOV,55,118,463,199,631,8,0,168
IMG_3326.MOV,56,119,463,199,633,8,0,170
IMG_3326.MOV,57,119,461,200,633,8,0,172
IMG_3326.MOV,58,121,462,200,634,8,0,172
IMG_3326.MOV,59,123,464,201,631,8,0,167
IMG_3326.MOV,60,125,464,202,631,8,0,167
IMG_3326.MOV,61,125,464,203,631,8,0,167
IMG_3326.MOV,62,125,464,203,632,8,0,168
IMG_3326.MOV,63,125,465,203,633,8,0,168
IMG_3326.MOV,64,126,464,204,634,8,0,170
IMG_3326.MOV,65,126,464,203,634,8,0,170
IMG_3326.MOV,66,126,464,204,634,8,0,170
IMG_3326.MOV,67,127,465,203,632,8,0,167
IMG_3326.MOV,68,128,465,204,632,8,0,167
IMG_3326.MOV,69,128,465,205,633,8,0,168
IMG_3326.MOV,70,128,465,204,633,8,0,168
IMG_3326.MOV,71,128,466,204,633,8,0,167
IMG_3326.MOV,72,128,468,203,633,8,0,165
IMG_3326.MOV,73,128,470,202,631,8,0,161
IMG_3326.MOV,74,129,473,201,630,8,0,157
IMG_3326.MOV,75,130,474,202,629,8,0,155
IMG_3326.MOV,76,130,476,200,627,8,0,151
IMG_3326.MOV,77,131,478,199,625,8,0,147
IMG_3326.MOV,78,131,478,200,625,8,0,147
IMG_3326.MOV,79,131,478,199,625,8,0,147
IMG_3326.MOV,80,131,479,199,624,8,1,145
IMG_3326.MOV,83,131,478,200,628,8,0,150
IMG_3326.MOV,84,132,477,202,630,8,0,153
IMG_3326.MOV,85,133,477,202,631,8,0,154
IMG_3326.MOV,86,133,477,202,631,8,1,154
IMG_3326.MOV,93,134,478,206,638,8,0,160
IMG_3326.MOV,94,135,479,207,639,8,0,160
IMG_3326.MOV,95,135,480,207,640,8,0,160
IMG_3326.MOV,96,136,480,208,639,8,0,159
IMG_3326.MOV,97,137,480,208,638,8,0,158
IMG_3326.MOV,98,138,481,208,636,8,0,155
IMG_3326.MOV,99,139,481,209,636,8,1,155
IMG_3326.MOV,103,151,478,227,647,8,0,169
IMG_3326.MOV,104,153,477,229,648,8,0,171
IMG_3326.MOV,105,154,477,231,649,8,1,172
IMG_3326.MOV,106,153,477,229,650,8,0,173
IMG_3326.MOV,107,153,476,229,650,8,0,174
IMG_3326.MOV,108,153,475,230,650,8,0,175
IMG_3326.MOV,109,154,474,230,649,8,0,175
IMG_3326.MOV,110,154,473,231,650,8,0,177
IMG_3326.MOV,111,154,473,230,650,8,0,177
IMG_3326.MOV,112,154,473,231,651,8,0,178
IMG_3326.MOV,113,156,473,232,647,8,0,174
IMG_3326.MOV,114,157,475,231,645,8,0,170
IMG_3326.MOV,115,157,474,231,645,8,0,171
IMG_3326.MOV,116,158,474,233,645,8,0,171
IMG_3326.MOV,117,158,474,234,647,8,0,173
IMG_3326.MOV,118,159,475,236,650,8,0,175
IMG_3326.MOV,119,161,477,238,650,8,0,173
IMG_3326.MOV,120,162,477,239,650,8,0,173
IMG_3326.MOV,121,162,479,240,652,8,0,173
IMG_3326.MOV,122,162,479,240,652,8,0,173
IMG_3326.MOV,123,163,480,241,654,8,0,174
IMG_3326.MOV,124,163,481,241,655,8,0,174
IMG_3326.MOV,125,164,481,242,655,8,0,174
IMG_3326.MOV,126,165,481,243,655,8,0,174
IMG_3326.MOV,127,166,482,244,655,8,0,173
IMG_3326.MOV,128,167,482,245,655,8,0,173
IMG_3326.MOV,129,169,482,247,653,8,0,171
IMG_3326.MOV,130,172,483,248,653,8,0,170
IMG_3326.MOV,131,172,483,249,654,8,0,171
IMG_3326.MOV,132,172,484,250,654,8,0,170
IMG_3326.MOV,133,174,484,251,653,8,0,169
IMG_3326.MOV,134,174,484,251,653,8,0,169
IMG_3326.MOV,135,174,484,250,654,8,0,170
IMG_3326.MOV,136,174,484,250,654,8,0,170
IMG_3326.MOV,137,175,492,249,661,8,0,169
IMG_3326.MOV,138,175,493,250,662,8,1,169
IMG_3326.MOV,144,176,481,251,653,8,0,172
IMG_3326.MOV,145,184,475,265,661,8,0,186
IMG_3326.MOV,146,187,473,269,663,8,0,190
IMG_3326.MOV,147,188,470,270,665,8,0,195
IMG_3326.MOV,148,187,468,271,667,8,0,199
IMG_3326.MOV,149,187,466,271,670,8,0,204
IMG_3326.MOV,150,188,466,271,670,8,0,204
IMG_3326.MOV,151,189,468,271,670,8,0,202
IMG_3326.MOV,152,190,469,271,669,8,0,200
IMG_3326.MOV,153,192,472,271,668,8,0,196
IMG_3326.MOV,154,194,475,271,666,8,0,191
IMG_3326.MOV,155,193,486,268,670,8,0,184
IMG_3326.MOV,156,193,490,266,671,8,0,181
IMG_3326.MOV,157,191,479,265,663,8,0,184
IMG_3326.MOV,158,193,489,265,667,8,0,178
IMG_3326.MOV,159,195,492,266,668,8,0,176
IMG_3326.MOV,160,195,494,267,670,8,0,176
IMG_3326.MOV,161,196,483,272,669,8,0,186
IMG_3326.MOV,162,197,479,274,668,8,0,189
IMG_3326.MOV,163,198,479,276,669,8,0,190
IMG_3326.MOV,164,198,478,277,671,8,0,193
IMG_3326.MOV,165,200,478,280,672,8,0,194
IMG_3326.MOV,166,201,478,283,673,8,0,195
IMG_3326.MOV,167,202,479,285,675,8,0,196
IMG_3326.MOV,168,202,479,287,676,8,0,197
IMG_3326.MOV,169,202,479,287,677,8,0,198
IMG_3326.MOV,170,201,479,287,676,8,0,197
IMG_3326.MOV,171,199,480,285,677,8,0,197
IMG_3326.MOV,172,199,482,284,677,8,0,195
IMG_3326.MOV,173,200,483,285,675,8,0,192
IMG_3326.MOV,174,202,484,287,675,8,0,191
IMG_3326.MOV,175,203,484,288,675,8,0,191
IMG_3326.MOV,176,203,485,288,676,8,0,191
IMG_3326.MOV,177,203,485,288,676,8,0,191
IMG_3326.MOV,178,202,493,283,673,8,0,180
IMG_3326.MOV,179,202,496,282,673,8,0,177
IMG_3326.MOV,180,202,496,282,673,8,0,177
IMG_3326.MOV,181,203,495,284,674,8,0,179
IMG_3326.MOV,182,203,488,288,677,8,0,189
IMG_3326.MOV,183,204,485,292,679,8,0,194
IMG_3326.MOV,184,205,484,293,680,8,0,196
IMG_3326.MOV,185,205,491,289,678,8,0,187
IMG_3326.MOV,186,204,494,286,676,8,0,182
IMG_3326.MOV,187,205,496,285,674,8,0,178
IMG_3326.MOV,188,205,497,284,674,8,0,177
IMG_3326.MOV,189,205,497,284,674,8,0,177
IMG_3326.MOV,190,205,497,283,674,8,0,177
IMG_3326.MOV,191,205,496,283,674,8,0,178
IMG_3326.MOV,192,205,494,284,674,8,0,180
IMG_3326.MOV,193,201,480,287,678,8,0,198
IMG_3326.MOV,194,198,475,287,678,8,0,203
IMG_3326.MOV,195,197,474,286,678,8,0,204
IMG_3326.MOV,196,196,474,285,678,8,0,204
IMG_3326.MOV,197,197,474,286,678,8,0,204
IMG_3326.MOV,198,197,474,287,679,8,0,205
IMG_3326.MOV,199,198,475,288,680,8,0,205
IMG_3326.MOV,200,198,473,289,681,8,0,208
IMG_3326.MOV,201,198,471,289,681,8,0,210
IMG_3326.MOV,202,199,473,289,683,8,0,210
IMG_3326.MOV,203,200,474,290,684,8,0,210
IMG_3326.MOV,204,201,476,290,685,8,0,209
IMG_3326.MOV,205,202,478,290,685,8,0,207
IMG_3326.MOV,206,203,480,290,684,8,0,204
IMG_3326.MOV,207,206,480,292,685,8,0,205
IMG_3326.MOV,208,207,481,294,685,8,0,204
IMG_3326.MOV,209,207,480,294,686,8,0,206
IMG_3326.MOV,210,207,480,293,686,8,0,206
IMG_3326.MOV,211,207,480,293,687,8,0,207
IMG_3326.MOV,212,206,481,292,688,8,0,207
IMG_3326.MOV,213,207,483,292,688,8,0,205
IMG_3326.MOV,214,209,484,293,686,8,0,202
IMG_3326.MOV,215,210,484,294,685,8,0,201
IMG_3326.MOV,216,209,484,293,685,8,0,201
IMG_3326.MOV,217,207,482,292,684,8,0,202
IMG_3326.MOV,218,209,483,294,684,8,0,201
IMG_3326.MOV,219,214,483,299,683,8,0,200
IMG_3326.MOV,220,216,485,301,683,8,0,198
IMG_3326.MOV,221,217,488,302,683,8,0,195
IMG_3326.MOV,222,218,490,303,683,8,0,193
IMG_3326.MOV,223,224,497,306,683,8,0,186
IMG_3326.MOV,224,228,501,308,683,8,0,182
IMG_3326.MOV,225,229,501,309,682,8,0,181
IMG_3326.MOV,226,229,501,309,682,8,0,181
IMG_3326.MOV,227,230,500,311,681,8,0,181
IMG_3326.MOV,228,231,500,312,681,8,0,181
IMG_3326.MOV,229,227,492,313,683,8,0,191
IMG_3326.MOV,230,225,490,313,682,8,0,192
IMG_3326.MOV,231,229,497,313,680,8,0,183
IMG_3326.MOV,232,230,500,313,679,8,0,179
IMG_3326.MOV,233,232,501,313,679,8,0,178
IMG_3326.MOV,234,233,502,314,678,8,0,176
IMG_3326.MOV,235,234,503,315,677,8,0,174
IMG_3326.MOV,236,234,504,316,678,8,0,174
IMG_3326.MOV,237,236,503,317,677,8,0,174
IMG_3326.MOV,238,236,501,318,677,8,0,176
IMG_3326.MOV,239,236,501,318,676,8,0,175
IMG_3326.MOV,240,237,501,319,676,8,0,175
IMG_3326.MOV,241,237,499,320,676,8,0,177
IMG_3326.MOV,242,235,493,323,680,8,0,187
IMG_3326.MOV,243,236,496,322,680,8,0,184
IMG_3326.MOV,244,236,496,322,680,8,0,184
IMG_3326.MOV,245,234,493,323,684,8,0,191
IMG_3326.MOV,246,236,497,322,684,8,0,187
IMG_3326.MOV,247,237,498,323,685,8,0,187
IMG_3326.MOV,248,238,499,323,685,8,0,186
IMG_3326.MOV,249,239,499,324,685,8,0,186
IMG_3326.MOV,250,240,499,324,686,8,0,187
IMG_3326.MOV,251,240,499,325,687,8,0,188
IMG_3326.MOV,252,241,496,327,688,8,0,192
IMG_3326.MOV,253,242,496,328,689,8,0,193
IMG_3326.MOV,254,243,495,329,687,8,0,192
IMG_3326.MOV,255,244,496,329,686,8,0,190
IMG_3326.MOV,256,252,488,344,692,8,0,204
IMG_3326.MOV,257,255,486,350,694,8,0,208
IMG_3326.MOV,258,255,483,353,698,8,0,215
IMG_3326.MOV,259,256,483,355,700,8,0,217
IMG_3326.MOV,260,256,483,356,702,8,0,219
IMG_3326.MOV,261,256,483,356,702,8,0,219
IMG_3326.MOV,262,257,484,355,698,8,0,214
IMG_3326.MOV,263,256,484,356,700,8,0,216
IMG_3326.MOV,264,255,485,357,701,8,0,216
IMG_3326.MOV,265,258,496,353,694,8,0,198
IMG_3326.MOV,266,260,499,353,691,8,0,192
IMG_3326.MOV,267,257,491,357,698,8,0,207
IMG_3326.MOV,268,256,489,359,699,8,0,210
IMG_3326.MOV,269,255,489,360,701,8,0,212
IMG_3326.MOV,270,255,488,361,701,8,0,213
IMG_3326.MOV,271,255,487,361,700,8,0,213
IMG_3326.MOV,272,255,488,360,698,8,0,210
IMG_3326.MOV,273,254,487,360,698,8,0,211
IMG_3326.MOV,274,255,489,360,698,8,0,209
IMG_3326.MOV,275,255,491,359,698,8,0,207
IMG_3326.MOV,276,256,493,358,697,8,0,204
IMG_3326.MOV,277,257,494,358,698,8,0,204
IMG_3326.MOV,278,259,495,360,698,8,0,203
IMG_3326.MOV,279,261,497,361,697,8,0,200
IMG_3326.MOV,280,264,499,361,696,8,0,197
IMG_3326.MOV,281,265,500,361,695,8,0,195
IMG_3326.MOV,282,265,497,363,695,8,0,198
IMG_3326.MOV,283,266,496,364,695,8,0,199
IMG_3326.MOV,284,267,495,364,695,8,0,200
IMG_3326.MOV,285,268,495,366,695,8,0,200
IMG_3326.MOV,286,270,497,366,696,8,0,199
IMG_3326.MOV,287,270,493,368,697,8,0,204
IMG_3326.MOV,288,270,491,369,698,8,0,207
IMG_3326.MOV,289,271,491,370,699,8,0,208
IMG_3326.MOV,290,272,497,367,697,8,0,200
IMG_3326.MOV,291,273,498,366,697,8,0,199
IMG_3326.MOV,292,275,499,365,696,8,0,197
IMG_3326.MOV,293,277,501,366,697,8,0,196
IMG_3326.MOV,294,277,492,371,702,8,0,210
IMG_3326.MOV,295,278,486,374,703,8,0,217
IMG_3326.MOV,296,279,486,374,702,8,0,216
IMG_3326.MOV,297,281,489,373,702,8,0,213
IMG_3326.MOV,298,283,490,374,701,8,0,211
IMG_3326.MOV,299,285,493,375,702,8,0,209
IMG_3326.MOV,300,286,494,375,702,8,0,208
IMG_3326.MOV,301,288,494,376,702,8,0,208
IMG_3326.MOV,302,289,496,376,701,8,0,205
IMG_3326.MOV,303,290,496,377,700,8,0,204
IMG_3326.MOV,304,293,498,379,700,8,0,202
IMG_3326.MOV,305,298,502,382,697,8,0,195
IMG_3326.MOV,306,299,504,383,697,8,0,193
IMG_3326.MOV,307,297,499,384,700,8,0,201
IMG_3326.MOV,308,296,496,385,702,8,0,206
IMG_3326.MOV,309,296,494,386,702,8,0,208
IMG_3326.MOV,310,298,494,387,704,8,0,210
IMG_3326.MOV,311,299,494,389,704,8,0,210
IMG_3326.MOV,312,302,501,386,701,8,0,200
IMG_3326.MOV,313,304,505,386,699,8,0,194
IMG_3326.MOV,314,306,507,387,699,8,0,192
IMG_3326.MOV,315,304,500,391,707,8,0,207
IMG_3326.MOV,316,305,498,393,709,8,0,211
IMG_3326.MOV,317,307,498,394,710,8,0,212
IMG_3326.MOV,318,307,498,394,711,8,0,213
IMG_3326.MOV,319,311,504,393,705,8,0,201
IMG_3326.MOV,320,312,506,393,705,8,0,199
IMG_3326.MOV,321,311,500,395,709,8,0,209
IMG_3326.MOV,322,311,498,396,710,8,0,212
IMG_3326.MOV,323,310,497,396,711,8,0,214
IMG_3326.MOV,324,311,496,397,712,8,0,216
IMG_3326.MOV,325,311,495,398,713,8,0,218
IMG_3326.MOV,326,312,493,400,714,8,0,221
IMG_3326.MOV,327,313,493,400,713,8,0,220
IMG_3326.MOV,328,314,494,401,713,8,0,219
IMG_3326.MOV,329,315,496,401,712,8,0,216
IMG_3326.MOV,330,316,497,401,711,8,0,214
IMG_3326.MOV,331,317,499,400,708,8,0,209
IMG_3326.MOV,332,317,499,400,708,8,0,209
IMG_3326.MOV,333,317,501,399,707,8,0,206
IMG_3326.MOV,334,321,520,396,707,8,0,187
IMG_3326.MOV,335,323,527,394,706,8,0,179
IMG_3326.MOV,336,324,530,394,706,8,1,176
IMG_3326.MOV,337,336,509,417,706,8,0,197
IMG_3326.MOV,338,338,509,420,705,8,1,196
IMG_3326.MOV,340,327,525,403,708,8,0,183
IMG_3326.MOV,341,333,507,418,712,8,0,205
IMG_3326.MOV,342,335,502,422,713,8,0,211
IMG_3326.MOV,343,336,498,425,714,8,0,216
IMG_3326.MOV,344,337,497,426,715,8,0,218
IMG_3326.MOV,345,338,497,427,715,8,0,218
IMG_3326.MOV,346,340,498,428,714,8,0,216
IMG_3326.MOV,347,342,498,429,713,8,0,215
IMG_3326.MOV,348,342,507,428,723,8,0,216
IMG_3326.MOV,349,343,511,429,727,8,0,216
IMG_3326.MOV,350,347,519,427,723,8,0,204
IMG_3326.MOV,351,348,519,426,721,8,0,202
IMG_3326.MOV,352,350,518,428,721,8,0,203
IMG_3326.MOV,353,352,520,428,722,8,0,202
IMG_3326.MOV,354,353,520,429,720,8,0,200
IMG_3326.MOV,355,356,522,429,720,8,0,198
IMG_3326.MOV,356,357,523,430,721,8,0,198
IMG_3326.MOV,357,359,523,431,720,8,0,197
IMG_3326.MOV,358,359,522,431,719,8,0,197
IMG_3326.MOV,359,360,523,433,719,8,0,196
IMG_3326.MOV,360,362,521,437,723,8,0,202
IMG_3326.MOV,361,364,520,439,723,8,0,203
IMG_3326.MOV,362,365,520,441,724,8,0,204
IMG_3326.MOV,363,366,520,443,726,8,0,206
IMG_3326.MOV,364,367,520,444,727,8,0,207
IMG_3326.MOV,365,368,519,446,727,8,0,208
IMG_3326.MOV,366,368,519,446,727,8,0,208
IMG_3326.MOV,367,369,520,448,727,8,0,207
IMG_3326.MOV,368,371,521,449,726,8,0,205
IMG_3326.MOV,369,371,521,449,726,8,0,205
IMG_3326.MOV,370,371,521,449,726,8,0,205
IMG_3326.MOV,371,370,521,449,726,8,0,205
IMG_3326.MOV,372,371,521,450,727,8,0,206
IMG_3326.MOV,373,375,521,454,727,8,0,206
IMG_3326.MOV,374,377,522,457,727,8,0,205
IMG_3326.MOV,375,380,524,459,727,8,0,203
IMG_3326.MOV,376,382,526,461,727,8,0,201
IMG_3326.MOV,377,383,526,462,728,8,0,202
IMG_3326.MOV,378,385,529,463,727,8,0,198
IMG_3326.MOV,379,387,532,463,726,8,0,194
IMG_3326.MOV,380,389,535,463,725,8,0,190
IMG_3326.MOV,381,389,537,462,724,8,0,187
IMG_3326.MOV,382,390,536,463,724,8,0,188
IMG_3326.MOV,383,391,534,464,724,8,0,190
IMG_3326.MOV,384,393,533,466,725,8,0,192
IMG_3326.MOV,385,393,533,466,725,8,0,192
IMG_3326.MOV,386,395,534,466,723,8,0,189
IMG_3326.MOV,387,397,535,468,723,8,0,188
IMG_3326.MOV,388,397,536,467,722,8,0,186
IMG_3326.MOV,389,396,533,468,725,8,0,192
IMG_3326.MOV,390,395,531,469,726,8,0,195
IMG_3326.MOV,391,393,529,469,727,8,0,198
IMG_3326.MOV,392,395,531,469,727,8,0,196
IMG_3326.MOV,393,398,536,471,729,8,0,193
IMG_3326.MOV,394,399,537,471,730,8,0,193
IMG_3326.MOV,395,407,530,483,733,8,0,203
IMG_3326.MOV,396,411,532,487,733,8,0,201
IMG_3326.MOV,397,413,531,488,732,8,0,201
IMG_3326.MOV,398,413,530,490,733,8,0,203
IMG_3326.MOV,399,415,530,491,733,8,0,203
IMG_3326.MOV,400,417,529,495,734,8,0,205
IMG_3326.MOV,401,417,528,496,736,8,0,208
IMG_3326.MOV,402,419,531,497,737,8,0,206
IMG_3326.MOV,403,421,534,499,737,8,0,203
IMG_3326.MOV,404,423,536,500,737,8,0,201
IMG_3326.MOV,405,423,536,500,738,8,0,202
IMG_3326.MOV,406,425,534,503,741,8,0,207
IMG_3326.MOV,407,426,534,504,742,8,0,208
IMG_3326.MOV,408,427,532,505,741,8,0,209
IMG_3326.MOV,409,427,530,505,742,8,0,212
IMG_3326.MOV,410,428,528,506,742,8,0,214
IMG_3326.MOV,411,429,527,508,744,8,0,217
IMG_3326.MOV,412,432,527,508,743,8,0,216
IMG_3326.MOV,413,434,530,508,740,8,0,210
IMG_3326.MOV,414,437,536,507,738,8,0,202
IMG_3326.MOV,415,440,542,505,732,8,0,190
IMG_3326.MOV,416,441,542,506,733,8,0,191
IMG_3326.MOV,417,449,531,520,738,8,0,207
IMG_3326.MOV,418,453,530,525,740,8,0,210
IMG_3326.MOV,419,454,530,528,742,8,0,212
IMG_3326.MOV,420,455,532,530,743,8,0,211
IMG_3326.MOV,421,456,530,531,744,8,0,214
IMG_3326.MOV,422,455,526,532,747,8,0,221
IMG_3326.MOV,423,456,525,534,749,8,0,224
IMG_3326.MOV,424,456,524,534,751,8,0,227
IMG_3326.MOV,425,457,524,536,752,8,0,228
IMG_3326.MOV,426,458,525,536,752,8,0,227
IMG_3326.MOV,427,459,527,536,752,8,0,225
IMG_3326.MOV,428,460,530,535,751,8,0,221
IMG_3326.MOV,429,461,530,535,751,8,0,221
IMG_3326.MOV,430,463,530,537,752,8,0,222
IMG_3326.MOV,431,464,530,537,748,8,0,218
IMG_3326.MOV,432,465,532,537,746,8,0,214
IMG_3326.MOV,433,466,533,538,745,8,0,212
IMG_3326.MOV,434,458,474,550,749,8,0,275
IMG_3326.MOV,435,464,505,546,745,8,0,240
IMG_3326.MOV,436,469,527,543,741,8,0,214
IMG_3326.MOV,437,472,548,544,752,8,0,204
IMG_3326.MOV,438,482,558,554,759,8,0,201
IMG_3326.MOV,439,475,549,552,763,8,0,214
IMG_3326.MOV,440,485,540,570,769,8,0,229
IMG_3326.MOV,441,490,539,578,771,8,0,232
IMG_3326.MOV,442,492,537,582,771,8,0,234
IMG_3326.MOV,443,490,537,582,771,8,0,234
IMG_3326.MOV,444,490,539,581,771,8,0,232
IMG_3326.MOV,445,492,542,584,770,8,0,228
IMG_3326.MOV,446,494,541,588,771,8,0,230
IMG_3326.MOV,447,492,539,587,771,8,0,232
IMG_3326.MOV,448,492,540,586,771,8,0,231
IMG_3326.MOV,449,492,542,585,770,8,0,228
IMG_3326.MOV,450,492,543,584,770,8,0,227
IMG_3326.MOV,451,492,549,579,765,8,0,216
IMG_3326.MOV,452,477,476,586,756,8,0,280
IMG_3326.MOV,453,490,518,584,755,8,0,237
IMG_3326.MOV,454,495,541,581,758,8,0,217
IMG_3326.MOV,455,477,470,587,758,8,0,288
IMG_3326.MOV,456,474,447,589,759,8,0,312
IMG_3326.MOV,457,473,439,584,748,8,0,309
IMG_3326.MOV,458,472,429,585,747,8,1,318
IMG_3326.MOV,460,471,428,587,762,8,0,334
IMG_3326.MOV,461,475,434,579,741,8,0,307
IMG_3326.MOV,462,479,440,571,715,8,0,275
IMG_3326.MOV,463,481,443,568,709,8,0,266
IMG_3326.MOV,464,482,445,566,706,8,0,261
IMG_3326.MOV,465,484,448,563,696,8,0,248
IMG_3326.MOV,466,485,449,562,690,8,0,241
IMG_3326.MOV,467,485,449,561,687,8,0,238
IMG_3326.MOV,468,485,449,561,686,8,0,237
IMG_3326.MOV,469,485,449,560,687,8,0,238
IMG_3326.MOV,470,485,449,560,685,8,0,236
IMG_3326.MOV,471,485,450,559,682,8,0,232
IMG_3326.MOV,472,486,451,559,682,8,0,231
IMG_3326.MOV,473,486,450,559,681,8,0,231
IMG_3326.MOV,474,486,449,559,679,8,0,230
IMG_3326.MOV,475,486,448,559,678,8,0,230
IMG_3326.MOV,476,487,447,560,679,8,0,232
IMG_3326.MOV,477,486,446,560,679,8,0,233
IMG_3326.MOV,478,487,446,561,680,8,0,234
IMG_3326.MOV,479,487,445,561,680,8,0,235
IMG_3326.MOV,480,487,445,561,680,8,0,235
IMG_3326.MOV,481,486,446,561,681,8,0,235
IMG_3326.MOV,482,487,447,561,680,8,0,233
IMG_3326.MOV,483,486,446,561,680,8,0,234
IMG_3326.MOV,484,486,446,561,680,8,0,234
IMG_3326.MOV,485,486,446,562,680,8,0,234
IMG_3326.MOV,486,486,447,562,679,8,0,232
IMG_3326.MOV,487,486,448,561,678,8,0,230
IMG_3326.MOV,488,486,448,562,677,8,0,229
IMG_3326.MOV,489,485,449,561,676,8,0,227
IMG_3326.MOV,490,485,451,560,673,8,0,222
IMG_3326.MOV,491,485,451,561,672,8,0,221
IMG_3326.MOV,492,484,451,561,671,8,0,220
IMG_3326.MOV,493,482,446,562,674,8,0,228
IMG_3326.MOV,494,481,444,562,675,8,0,231
IMG_3326.MOV,495,480,443,563,675,8,0,232
IMG_3326.MOV,496,480,442,564,675,8,0,233
IMG_3326.MOV,497,479,442,564,674,8,0,232
IMG_3326.MOV,498,470,444,557,675,8,0,231
IMG_3326.MOV,499,466,446,554,675,8,0,229
IMG_3326.MOV,500,465,447,554,676,8,0,229
IMG_3326.MOV,501,471,444,562,676,8,0,232
IMG_3326.MOV,502,474,443,565,675,8,0,232
IMG_3326.MOV,503,475,443,567,675,8,0,232
IMG_3326.MOV,504,477,445,568,673,8,0,228
IMG_3326.MOV,505,477,446,568,673,8,0,227
IMG_3326.MOV,506,477,446,568,672,8,0,226
IMG_3326.MOV,507,478,448,569,671,8,0,223
IMG_3326.MOV,508,478,448,569,671,8,0,223
IMG_3326.MOV,509,480,450,570,670,8,0,220
IMG_3326.MOV,510,480,450,571,670,8,0,220
IMG_3326.MOV,511,480,451,571,670,8,0,219
IMG_3326.MOV,512,481,452,571,671,8,0,219
IMG_3326.MOV,513,481,453,572,671,8,0,218
IMG_3326.MOV,514,482,453,572,672,8,0,219
IMG_3326.MOV,515,482,452,572,672,8,0,220
IMG_3326.MOV,516,483,452,573,671,8,0,219
IMG_3326.MOV,517,484,452,574,671,8,0,219
IMG_3326.MOV,518,485,452,574,670,8,0,218
IMG_3326.MOV,519,486,452,574,670,8,0,218
IMG_3326.MOV,520,487,452,575,670,8,0,218
IMG_3326.MOV,521,487,452,574,670,8,0,218
IMG_3326.MOV,522,487,452,575,669,8,0,217
IMG_3326.MOV,523,488,452,575,670,8,0,218
IMG_3326.MOV,524,490,452,576,670,8,0,218
IMG_3326.MOV,525,490,453,576,670,8,0,217
IMG_3326.MOV,526,490,452,576,670,8,0,218
IMG_3326.MOV,527,491,453,577,671,8,0,218
IMG_3326.MOV,528,492,453,577,671,8,0,218
IMG_3326.MOV,529,494,454,578,671,8,0,217
IMG_3326.MOV,530,495,454,579,671,8,0,217
IMG_3326.MOV,531,496,455,580,671,8,0,216
IMG_3326.MOV,532,497,455,581,671,8,0,216
IMG_3326.MOV,533,498,456,582,671,8,0,215
IMG_3326.MOV,534,499,457,582,671,8,0,214
IMG_3326.MOV,535,500,458,582,671,8,0,213
IMG_3326.MOV,536,500,457,583,671,8,0,214
IMG_3326.MOV,537,501,458,583,672,8,0,214
IMG_3326.MOV,538,501,459,584,672,8,0,213
IMG_3326.MOV,539,502,462,583,671,8,0,209
IMG_3326.MOV,540,502,463,583,671,8,0,208
IMG_3326.MOV,541,501,463,583,672,8,0,209
IMG_3326.MOV,542,502,463,586,677,8,0,214
IMG_3326.MOV,543,503,463,587,678,8,0,215
IMG_3326.MOV,544,503,465,587,679,8,0,214
IMG_3326.MOV,545,503,466,588,679,8,0,213
IMG_3326.MOV,546,503,466,588,678,8,0,212
IMG_3326.MOV,547,505,468,588,677,8,0,209
IMG_3326.MOV,548,507,470,588,676,8,0,206
IMG_3326.MOV,549,508,471,589,676,8,0,205
IMG_3326.MOV,550,510,473,589,675,8,0,202
IMG_3326.MOV,551,511,474,589,674,8,0,200
IMG_3326.MOV,552,511,475,589,674,8,0,199
IMG_3326.MOV,553,511,476,589,675,8,0,199
IMG_3326.MOV,554,511,475,590,676,8,0,201
IMG_3326.MOV,555,512,476,590,676,8,0,200
IMG_3326.MOV,556,512,477,589,676,8,0,199
IMG_3326.MOV,557,513,479,589,675,8,0,196
IMG_3326.MOV,558,514,479,590,673,8,0,194
IMG_3326.MOV,559,523,488,594,672,8,0,184
IMG_3326.MOV,560,526,491,594,672,8,0,181
IMG_3326.MOV,561,527,493,595,673,8,0,180
IMG_3326.MOV,562,529,492,596,674,8,0,182
IMG_3326.MOV,563,530,493,595,674,8,0,181
IMG_3326.MOV,564,531,491,596,674,8,0,183
IMG_3326.MOV,565,532,490,596,674,8,0,184
IMG_3326.MOV,566,533,491,597,674,8,1,183
IMG_3326.MOV,1,460,383,514,584,9,0,201
IMG_3326.MOV,2,459,384,513,584,9,0,200
IMG_3326.MOV,3,459,385,512,584,9,0,199
IMG_3326.MOV,4,459,386,512,583,9,0,197
IMG_3326.MOV,5,459,386,513,584,9,0,198
IMG_3326.MOV,6,459,387,512,584,9,0,197
IMG_3326.MOV,7,459,388,512,584,9,0,196
IMG_3326.MOV,8,459,388,512,585,9,1,197
IMG_3326.MOV,1,1761,532,1894,914,10,0,382
IMG_3326.MOV,2,1762,534,1894,915,10,0,381
IMG_3326.MOV,3,1762,534,1894,916,10,0,382
IMG_3326.MOV,4,1762,534,1894,917,10,0,383
IMG_3326.MOV,5,1761,532,1895,925,10,0,393
IMG_3326.MOV,6,1763,532,1896,923,10,0,391
IMG_3326.MOV,7,1765,532,1896,924,10,0,392
IMG_3326.MOV,8,1767,532,1897,924,10,0,392
IMG_3326.MOV,9,1768,532,1897,923,10,0,391
IMG_3326.MOV,10,1768,533,1898,924,10,1,391
IMG_3326.MOV,12,1772,531,1900,924,10,0,393
IMG_3326.MOV,13,1773,531,1900,925,10,0,394
IMG_3326.MOV,14,1775,531,1901,926,10,0,395
IMG_3326.MOV,15,1783,527,1914,938,10,0,411
IMG_3326.MOV,16,1786,524,1920,946,10,0,422
IMG_3326.MOV,17,1788,524,1923,949,10,1,425
IMG_3326.MOV,1,50,365,108,539,11,0,174
IMG_3326.MOV,2,51,365,108,540,11,0,175
IMG_3326.MOV,3,51,366,108,542,11,0,176
IMG_3326.MOV,4,50,366,108,543,11,0,177
IMG_3326.MOV,5,50,366,107,543,11,0,177
IMG_3326.MOV,6,50,366,107,544,11,0,178
IMG_3326.MOV,7,49,367,107,546,11,0,179
IMG_3326.MOV,8,49,366,107,547,11,0,181
IMG_3326.MOV,9,48,366,107,546,11,0,180
IMG_3326.MOV,10,49,365,107,547,11,0,182
IMG_3326.MOV,11,49,367,106,547,11,0,180
IMG_3326.MOV,12,49,367,106,546,11,0,179
IMG_3326.MOV,13,49,367,106,546,11,0,179
IMG_3326.MOV,14,49,367,106,545,11,0,178
IMG_3326.MOV,15,49,367,106,543,11,0,176
IMG_3326.MOV,16,49,367,105,543,11,0,176
IMG_3326.MOV,17,49,367,106,543,11,0,176
IMG_3326.MOV,18,49,366,106,543,11,0,177
IMG_3326.MOV,19,42,364,100,542,11,0,178
IMG_3326.MOV,20,39,364,98,543,11,0,179
IMG_3326.MOV,21,37,363,97,543,11,0,180
IMG_3326.MOV,22,37,364,97,543,11,0,179
IMG_3326.MOV,23,37,364,97,541,11,0,177
IMG_3326.MOV,24,37,365,97,541,11,0,176
IMG_3326.MOV,25,37,365,98,542,11,0,177
IMG_3326.MOV,26,36,366,98,542,11,0,176
IMG_3326.MOV,27,36,367,98,542,11,0,175
IMG_3326.MOV,28,35,367,98,541,11,0,174
IMG_3326.MOV,29,35,367,98,541,11,0,174
IMG_3326.MOV,30,35,367,98,541,11,0,174
IMG_3326.MOV,31,35,367,98,540,11,0,173
IMG_3326.MOV,32,34,366,98,539,11,0,173
IMG_3326.MOV,33,35,367,98,538,11,0,171
IMG_3326.MOV,34,35,367,98,537,11,0,170
IMG_3326.MOV,35,35,368,99,538,11,0,170
IMG_3326.MOV,36,35,368,99,539,11,0,171
IMG_3326.MOV,37,34,369,99,540,11,0,171
IMG_3326.MOV,38,34,370,100,540,11,0,170
IMG_3326.MOV,39,34,371,100,540,11,0,169
IMG_3326.MOV,40,34,371,101,540,11,0,169
IMG_3326.MOV,41,34,372,101,540,11,0,168
IMG_3326.MOV,42,33,372,101,540,11,0,168
IMG_3326.MOV,43,33,372,101,541,11,0,169
IMG_3326.MOV,44,33,371,102,541,11,0,170
IMG_3326.MOV,45,32,371,102,541,11,0,170
IMG_3326.MOV,46,39,373,108,542,11,0,169
IMG_3326.MOV,47,42,374,111,542,11,0,168
IMG_3326.MOV,48,43,375,112,542,11,0,167
IMG_3326.MOV,49,43,375,113,542,11,0,167
IMG_3326.MOV,50,43,374,113,541,11,0,167
IMG_3326.MOV,51,43,374,113,541,11,0,167
IMG_3326.MOV,52,43,374,113,541,11,0,167
IMG_3326.MOV,53,43,373,113,541,11,0,168
IMG_3326.MOV,54,43,373,113,540,11,0,167
IMG_3326.MOV,55,43,373,113,540,11,0,167
IMG_3326.MOV,56,44,373,113,540,11,0,167
IMG_3326.MOV,57,43,373,113,539,11,0,166
IMG_3326.MOV,58,43,373,113,539,11,0,166
IMG_3326.MOV,59,43,373,113,539,11,0,166
IMG_3326.MOV,60,44,373,113,539,11,0,166
IMG_3326.MOV,61,44,373,113,540,11,0,167
IMG_3326.MOV,62,44,373,113,540,11,0,167
IMG_3326.MOV,63,43,373,112,540,11,0,167
IMG_3326.MOV,64,43,373,112,541,11,0,168
IMG_3326.MOV,65,43,373,112,542,11,0,169
IMG_3326.MOV,66,43,373,112,542,11,0,169
IMG_3326.MOV,67,37,371,105,540,11,0,169
IMG_3326.MOV,68,35,371,102,538,11,0,167
IMG_3326.MOV,69,34,370,102,537,11,0,167
IMG_3326.MOV,70,34,370,101,538,11,0,168
IMG_3326.MOV,71,34,370,101,538,11,0,168
IMG_3326.MOV,72,34,370,101,539,11,0,169
IMG_3326.MOV,73,34,370,101,539,11,0,169
IMG_3326.MOV,74,33,371,100,540,11,0,169
IMG_3326.MOV,75,33,371,100,540,11,0,169
IMG_3326.MOV,76,34,371,100,540,11,0,169
IMG_3326.MOV,77,33,372,99,539,11,0,167
IMG_3326.MOV,78,33,373,98,539,11,0,166
IMG_3326.MOV,79,33,373,98,539,11,0,166
IMG_3326.MOV,80,33,374,97,538,11,0,164
IMG_3326.MOV,81,32,373,96,538,11,0,165
IMG_3326.MOV,82,32,373,96,538,11,0,165
IMG_3326.MOV,83,31,372,96,539,11,0,167
IMG_3326.MOV,84,30,372,95,539,11,0,167
IMG_3326.MOV,85,30,372,95,540,11,0,168
IMG_3326.MOV,86,29,371,94,540,11,0,169
IMG_3326.MOV,87,29,371,94,541,11,0,170
IMG_3326.MOV,88,30,371,94,541,11,0,170
IMG_3326.MOV,89,29,371,94,541,11,0,170
IMG_3326.MOV,90,29,371,93,541,11,0,170
IMG_3326.MOV,91,28,371,93,541,11,0,170
IMG_3326.MOV,92,28,371,92,542,11,0,171
IMG_3326.MOV,93,27,371,91,540,11,0,169
IMG_3326.MOV,94,27,372,90,540,11,0,168
IMG_3326.MOV,95,27,372,89,540,11,0,168
IMG_3326.MOV,96,26,372,88,539,11,0,167
IMG_3326.MOV,97,26,373,87,539,11,0,166
IMG_3326.MOV,98,26,373,87,538,11,0,165
IMG_3326.MOV,99,26,374,86,538,11,0,164
IMG_3326.MOV,100,26,374,85,538,11,0,164
IMG_3326.MOV,101,26,374,85,537,11,0,163
IMG_3326.MOV,102,25,375,83,537,11,0,162
IMG_3326.MOV,103,25,375,83,537,11,0,162
IMG_3326.MOV,104,25,375,83,536,11,0,161
IMG_3326.MOV,105,24,375,82,538,11,0,163
IMG_3326.MOV,106,24,374,82,538,11,0,164
IMG_3326.MOV,107,23,374,81,539,11,0,165
IMG_3326.MOV,108,22,374,81,539,11,0,165
IMG_3326.MOV,109,22,374,80,538,11,0,164
IMG_3326.MOV,110,21,374,79,537,11,0,163
IMG_3326.MOV,111,21,373,79,537,11,0,164
IMG_3326.MOV,112,20,373,79,536,11,0,163
IMG_3326.MOV,113,20,373,79,537,11,0,164
IMG_3326.MOV,114,20,373,79,539,11,0,166
IMG_3326.MOV,115,19,374,78,539,11,0,165
IMG_3326.MOV,116,19,375,77,539,11,0,164
IMG_3326.MOV,117,19,375,77,540,11,0,165
IMG_3326.MOV,118,19,376,77,540,11,0,164
IMG_3326.MOV,119,19,376,76,539,11,0,163
IMG_3326.MOV,120,19,376,76,539,11,0,163
IMG_3326.MOV,121,19,377,76,539,11,0,162
IMG_3326.MOV,122,19,377,75,539,11,0,162
IMG_3326.MOV,123,19,377,75,540,11,0,163
IMG_3326.MOV,124,19,376,75,540,11,0,164
IMG_3326.MOV,125,19,376,75,540,11,0,164
IMG_3326.MOV,126,19,376,74,539,11,0,163
IMG_3326.MOV,127,19,376,74,539,11,0,163
IMG_3326.MOV,128,19,376,73,538,11,0,162
IMG_3326.MOV,129,19,376,72,535,11,0,159
IMG_3326.MOV,130,19,377,71,534,11,0,157
IMG_3326.MOV,131,19,377,71,535,11,0,158
IMG_3326.MOV,132,18,376,71,534,11,0,158
IMG_3326.MOV,133,17,376,70,534,11,0,158
IMG_3326.MOV,134,16,375,69,534,11,0,159
IMG_3326.MOV,135,15,375,70,534,11,0,159
IMG_3326.MOV,136,14,374,69,535,11,0,161
IMG_3326.MOV,137,14,373,70,536,11,0,163
IMG_3326.MOV,138,13,372,70,537,11,0,165
IMG_3326.MOV,139,12,372,69,537,11,0,165
IMG_3326.MOV,140,12,372,69,536,11,0,164
IMG_3326.MOV,141,13,373,69,535,11,0,162
IMG_3326.MOV,142,12,373,69,535,11,0,162
IMG_3326.MOV,143,12,374,69,537,11,0,163
IMG_3326.MOV,144,12,375,69,537,11,0,162
IMG_3326.MOV,145,5,374,62,532,11,0,158
IMG_3326.MOV,146,3,375,60,530,11,0,155
IMG_3326.MOV,147,2,375,59,531,11,0,156
IMG_3326.MOV,148,2,376,59,532,11,0,156
IMG_3326.MOV,149,1,377,58,533,11,0,156
IMG_3326.MOV,150,0,379,57,532,11,0,153
IMG_3326.MOV,151,1,381,57,532,11,0,151
IMG_3326.MOV,152,0,380,58,533,11,0,153
IMG_3326.MOV,153,0,379,58,534,11,0,155
IMG_3326.MOV,154,0,379,58,535,11,0,156
IMG_3326.MOV,155,0,378,58,535,11,0,157
IMG_3326.MOV,1,418,383,479,590,12,0,207
IMG_3326.MOV,2,418,384,479,589,12,0,205
IMG_3326.MOV,3,419,384,479,588,12,0,204
IMG_3326.MOV,4,420,385,480,588,12,0,203
IMG_3326.MOV,5,420,385,480,589,12,0,204
IMG_3326.MOV,6,420,385,481,589,12,0,204
IMG_3326.MOV,7,419,386,481,588,12,0,202
IMG_3326.MOV,8,419,386,480,588,12,0,202
IMG_3326.MOV,9,419,386,481,589,12,0,203
IMG_3326.MOV,10,419,386,482,590,12,0,204
IMG_3326.MOV,11,418,385,483,590,12,0,205
IMG_3326.MOV,12,419,384,485,590,12,0,206
IMG_3326.MOV,13,419,384,485,589,12,0,205
IMG_3326.MOV,14,418,384,484,589,12,0,205
IMG_3326.MOV,15,418,383,484,589,12,0,206
IMG_3326.MOV,16,418,385,484,588,12,0,203
IMG_3326.MOV,17,418,385,484,588,12,0,203
IMG_3326.MOV,18,418,385,484,588,12,0,203
IMG_3326.MOV,19,418,385,483,587,12,0,202
IMG_3326.MOV,20,417,385,483,588,12,0,203
IMG_3326.MOV,21,417,385,483,590,12,0,205
IMG_3326.MOV,22,416,385,483,590,12,0,205
IMG_3326.MOV,23,416,386,482,590,12,0,204
IMG_3326.MOV,24,416,384,482,590,12,0,206
IMG_3326.MOV,25,416,384,482,590,12,0,206
IMG_3326.MOV,26,417,385,482,590,12,0,205
IMG_3326.MOV,27,416,385,481,590,12,0,205
IMG_3326.MOV,28,416,385,481,589,12,0,204
IMG_3326.MOV,29,416,387,481,591,12,0,204
IMG_3326.MOV,30,417,389,481,591,12,0,202
IMG_3326.MOV,31,417,390,480,591,12,0,201
IMG_3326.MOV,32,417,388,481,592,12,0,204
IMG_3326.MOV,33,417,387,481,593,12,0,206
IMG_3326.MOV,34,417,386,481,593,12,0,207
IMG_3326.MOV,35,417,387,481,593,12,0,206
IMG_3326.MOV,36,418,388,482,594,12,0,206
IMG_3326.MOV,37,418,388,482,594,12,0,206
IMG_3326.MOV,38,418,388,481,593,12,0,205
IMG_3326.MOV,39,418,388,481,593,12,0,205
IMG_3326.MOV,40,418,389,481,594,12,0,205
IMG_3326.MOV,41,418,390,482,595,12,0,205
IMG_3326.MOV,42,418,391,482,594,12,0,203
IMG_3326.MOV,43,418,392,482,594,12,0,202
IMG_3326.MOV,44,418,392,482,594,12,0,202
IMG_3326.MOV,45,418,392,482,594,12,0,202
IMG_3326.MOV,46,418,394,482,594,12,0,200
IMG_3326.MOV,47,419,395,482,592,12,0,197
IMG_3326.MOV,48,420,396,483,591,12,0,195
IMG_3326.MOV,49,420,396,484,591,12,0,195
IMG_3326.MOV,50,421,398,484,589,12,0,191
IMG_3326.MOV,51,422,399,484,587,12,0,188
IMG_3326.MOV,52,421,399,483,588,12,0,189
IMG_3326.MOV,53,421,398,484,589,12,0,191
IMG_3326.MOV,54,422,397,485,592,12,0,195
IMG_3326.MOV,55,422,398,485,592,12,0,194
IMG_3326.MOV,56,423,398,485,591,12,0,193
IMG_3326.MOV,57,423,399,484,591,12,0,192
IMG_3326.MOV,58,423,399,484,591,12,0,192
IMG_3326.MOV,59,423,398,484,590,12,0,192
IMG_3326.MOV,60,424,399,484,588,12,0,189
IMG_3326.MOV,61,425,408,486,600,12,0,192
IMG_3326.MOV,62,425,404,485,591,12,0,187
IMG_3326.MOV,63,425,411,486,600,12,0,189
IMG_3326.MOV,64,424,415,485,602,12,0,187
IMG_3326.MOV,65,424,415,485,604,12,0,189
IMG_3326.MOV,66,425,415,486,604,12,0,189
IMG_3326.MOV,67,424,415,486,603,12,0,188
IMG_3326.MOV,68,424,413,486,604,12,0,191
IMG_3326.MOV,69,423,404,485,592,12,0,188
IMG_3326.MOV,70,422,399,484,590,12,0,191
IMG_3326.MOV,71,422,398,485,590,12,0,192
IMG_3326.MOV,72,421,398,484,591,12,0,193
IMG_3326.MOV,73,421,398,484,592,12,0,194
IMG_3326.MOV,74,421,404,485,602,12,0,198
IMG_3326.MOV,75,421,400,484,596,12,0,196
IMG_3326.MOV,76,421,399,483,593,12,0,194
IMG_3326.MOV,77,422,406,484,601,12,0,195
IMG_3326.MOV,78,421,400,482,596,12,0,196
IMG_3326.MOV,79,420,398,482,596,12,0,198
IMG_3326.MOV,80,419,397,481,596,12,0,199
IMG_3326.MOV,81,419,396,480,596,12,0,200
IMG_3326.MOV,82,419,396,481,596,12,0,200
IMG_3326.MOV,83,419,396,481,597,12,0,201
IMG_3326.MOV,84,419,402,482,604,12,0,202
IMG_3326.MOV,85,420,406,482,607,12,0,201
IMG_3326.MOV,86,421,406,483,608,12,0,202
IMG_3326.MOV,87,421,407,483,609,12,0,202
IMG_3326.MOV,88,421,405,484,611,12,0,206
IMG_3326.MOV,89,421,404,485,612,12,0,208
IMG_3326.MOV,90,421,403,484,612,12,0,209
IMG_3326.MOV,91,421,403,484,611,12,0,208
IMG_3326.MOV,92,421,403,484,612,12,0,209
IMG_3326.MOV,93,421,403,484,612,12,0,209
IMG_3326.MOV,94,420,403,484,613,12,0,210
IMG_3326.MOV,95,422,402,486,613,12,0,211
IMG_3326.MOV,96,422,403,485,611,12,0,208
IMG_3326.MOV,97,422,396,486,605,12,0,209
IMG_3326.MOV,98,422,393,487,603,12,0,210
IMG_3326.MOV,99,422,392,487,600,12,0,208
IMG_3326.MOV,100,422,391,487,601,12,0,210
IMG_3326.MOV,101,421,398,487,610,12,0,212
IMG_3326.MOV,102,421,401,487,612,12,0,211
IMG_3326.MOV,103,421,403,486,613,12,0,210
IMG_3326.MOV,104,420,403,487,614,12,0,211
IMG_3326.MOV,105,420,403,486,615,12,0,212
IMG_3326.MOV,106,420,403,486,616,12,0,213
IMG_3326.MOV,107,419,402,486,616,12,0,214
IMG_3326.MOV,108,420,404,485,613,12,0,209
IMG_3326.MOV,109,419,404,484,611,12,0,207
IMG_3326.MOV,110,419,405,484,611,12,0,206
IMG_3326.MOV,111,418,404,484,612,12,0,208
IMG_3326.MOV,112,417,404,484,612,12,0,208
IMG_3326.MOV,113,417,404,484,612,12,0,208
IMG_3326.MOV,114,418,404,484,612,12,0,208
IMG_3326.MOV,115,418,405,485,612,12,0,207
IMG_3326.MOV,116,419,405,485,613,12,0,208
IMG_3326.MOV,117,419,407,485,613,12,0,206
IMG_3326.MOV,118,419,409,484,611,12,0,202
IMG_3326.MOV,119,418,408,484,613,12,0,205
IMG_3326.MOV,120,418,407,485,615,12,0,208
IMG_3326.MOV,121,418,406,485,615,12,0,209
IMG_3326.MOV,122,419,406,486,616,12,0,210
IMG_3326.MOV,123,420,408,487,615,12,0,207
IMG_3326.MOV,124,420,408,487,614,12,0,206
IMG_3326.MOV,125,419,407,487,614,12,0,207
IMG_3326.MOV,126,419,407,487,614,12,0,207
IMG_3326.MOV,127,420,408,487,613,12,0,205
IMG_3326.MOV,128,421,409,487,612,12,0,203
IMG_3326.MOV,129,421,409,486,612,12,0,203
IMG_3326.MOV,130,421,407,487,613,12,0,206
IMG_3326.MOV,131,421,405,488,614,12,0,209
IMG_3326.MOV,132,421,405,487,614,12,0,209
IMG_3326.MOV,133,421,405,487,614,12,0,209
IMG_3326.MOV,134,420,405,487,615,12,0,210
IMG_3326.MOV,135,420,406,487,615,12,0,209
IMG_3326.MOV,136,419,407,486,614,12,0,207
IMG_3326.MOV,137,419,408,485,614,12,0,206
IMG_3326.MOV,138,419,408,484,614,12,0,206
IMG_3326.MOV,139,419,410,484,613,12,0,203
IMG_3326.MOV,140,419,410,483,613,12,0,203
IMG_3326.MOV,141,419,411,483,613,12,0,202
IMG_3326.MOV,142,420,411,483,612,12,0,201
IMG_3326.MOV,143,420,410,483,613,12,0,203
IMG_3326.MOV,144,420,410,483,613,12,0,203
IMG_3326.MOV,145,420,410,482,612,12,0,202
IMG_3326.MOV,146,419,409,482,612,12,0,203
IMG_3326.MOV,147,420,409,481,612,12,0,203
IMG_3326.MOV,148,420,409,481,611,12,0,202
IMG_3326.MOV,149,420,409,481,610,12,0,201
IMG_3326.MOV,150,421,409,481,610,12,0,201
IMG_3326.MOV,151,421,409,481,610,12,0,201
IMG_3326.MOV,152,420,410,481,612,12,0,202
IMG_3326.MOV,153,420,410,481,612,12,0,202
IMG_3326.MOV,154,420,409,481,613,12,0,204
IMG_3326.MOV,155,420,408,481,615,12,0,207
IMG_3326.MOV,156,420,408,481,614,12,0,206
IMG_3326.MOV,157,421,407,481,612,12,0,205
IMG_3326.MOV,158,421,407,481,611,12,0,204
IMG_3326.MOV,159,421,408,480,611,12,0,203
IMG_3326.MOV,160,421,408,480,611,12,0,203
IMG_3326.MOV,161,422,407,481,612,12,0,205
IMG_3326.MOV,162,422,407,482,613,12,0,206
IMG_3326.MOV,163,422,407,482,613,12,0,206
IMG_3326.MOV,164,422,408,482,613,12,0,205
IMG_3326.MOV,165,421,408,482,615,12,0,207
IMG_3326.MOV,166,422,408,482,614,12,0,206
IMG_3326.MOV,167,422,409,483,614,12,0,205
IMG_3326.MOV,168,422,409,483,614,12,0,205
IMG_3326.MOV,169,423,409,484,614,12,0,205
IMG_3326.MOV,170,423,410,484,613,12,0,203
IMG_3326.MOV,171,423,410,484,612,12,0,202
IMG_3326.MOV,172,422,410,483,612,12,0,202
IMG_3326.MOV,173,422,410,483,612,12,0,202
IMG_3326.MOV,174,422,411,483,611,12,0,200
IMG_3326.MOV,175,422,411,483,611,12,0,200
IMG_3326.MOV,176,422,413,483,611,12,0,198
IMG_3326.MOV,177,423,412,484,611,12,0,199
IMG_3326.MOV,178,423,410,485,611,12,0,201
IMG_3326.MOV,179,422,410,485,611,12,0,201
IMG_3326.MOV,180,423,412,485,611,12,0,199
IMG_3326.MOV,181,424,415,486,611,12,0,196
IMG_3326.MOV,182,424,415,486,610,12,0,195
IMG_3326.MOV,183,424,419,485,610,12,0,191
IMG_3326.MOV,184,424,429,482,609,12,0,180
IMG_3326.MOV,185,423,429,482,609,12,0,180
IMG_3326.MOV,186,421,423,483,612,12,0,189
IMG_3326.MOV,187,421,424,484,613,12,0,189
IMG_3326.MOV,188,420,425,484,614,12,0,189
IMG_3326.MOV,189,419,421,484,614,12,0,193
IMG_3326.MOV,190,417,415,484,614,12,0,199
IMG_3326.MOV,191,416,410,485,614,12,0,204
IMG_3326.MOV,192,417,407,486,613,12,0,206
IMG_3326.MOV,193,419,407,487,613,12,0,206
IMG_3326.MOV,194,420,408,488,614,12,0,206
IMG_3326.MOV,195,420,408,488,614,12,0,206
IMG_3326.MOV,196,420,411,487,614,12,0,203
IMG_3326.MOV,197,421,413,486,612,12,0,199
IMG_3326.MOV,198,421,414,486,612,12,0,198
IMG_3326.MOV,199,422,420,485,612,12,0,192
IMG_3326.MOV,200,421,420,485,612,12,0,192
IMG_3326.MOV,201,421,413,486,612,12,0,199
IMG_3326.MOV,202,421,412,487,612,12,0,200
IMG_3326.MOV,203,422,414,487,613,12,0,199
IMG_3326.MOV,204,423,416,488,613,12,0,197
IMG_3326.MOV,205,424,418,487,615,12,0,197
IMG_3326.MOV,206,423,421,486,616,12,0,195
IMG_3326.MOV,207,424,422,486,616,12,0,194
IMG_3326.MOV,208,424,418,487,616,12,0,198
IMG_3326.MOV,209,423,417,486,616,12,0,199
IMG_3326.MOV,210,424,417,486,615,12,0,198
IMG_3326.MOV,211,425,413,489,615,12,0,202
IMG_3326.MOV,212,425,411,489,615,12,0,204
IMG_3326.MOV,213,425,408,490,614,12,0,206
IMG_3326.MOV,214,425,410,490,614,12,0,204
IMG_3326.MOV,215,425,408,491,614,12,0,206
IMG_3326.MOV,216,424,404,492,616,12,0,212
IMG_3326.MOV,217,425,403,494,615,12,0,212
IMG_3326.MOV,218,425,402,495,613,12,0,211
IMG_3326.MOV,219,424,401,495,611,12,0,210
IMG_3326.MOV,220,423,403,494,616,12,0,213
IMG_3326.MOV,221,422,406,492,615,12,0,209
IMG_3326.MOV,222,423,409,492,615,12,0,206
IMG_3326.MOV,223,423,409,492,617,12,0,208
IMG_3326.MOV,224,423,409,494,619,12,0,210
IMG_3326.MOV,225,424,408,494,620,12,0,212
IMG_3326.MOV,226,423,406,494,621,12,0,215
IMG_3326.MOV,227,423,404,494,622,12,0,218
IMG_3326.MOV,228,422,403,493,622,12,0,219
IMG_3326.MOV,229,422,402,493,623,12,0,221
IMG_3326.MOV,230,422,401,493,625,12,0,224
IMG_3326.MOV,231,422,397,493,621,12,0,224
IMG_3326.MOV,232,423,395,493,620,12,0,225
IMG_3326.MOV,233,423,394,493,620,12,0,226
IMG_3326.MOV,234,424,394,493,620,12,0,226
IMG_3326.MOV,235,425,393,494,618,12,0,225
IMG_3326.MOV,236,426,399,493,622,12,0,223
IMG_3326.MOV,237,427,402,493,623,12,0,221
IMG_3326.MOV,238,428,404,492,622,12,0,218
IMG_3326.MOV,239,430,405,494,623,12,0,218
IMG_3326.MOV,240,432,406,495,623,12,0,217
IMG_3326.MOV,241,434,409,495,620,12,0,211
IMG_3326.MOV,242,434,408,497,620,12,0,212
IMG_3326.MOV,243,434,410,496,618,12,0,208
IMG_3326.MOV,244,435,410,496,616,12,0,206
IMG_3326.MOV,245,436,408,498,616,12,0,208
IMG_3326.MOV,246,437,411,499,616,12,0,205
IMG_3326.MOV,247,436,412,498,618,12,0,206
IMG_3326.MOV,248,437,411,499,618,12,0,207
IMG_3326.MOV,249,437,410,500,618,12,0,208
IMG_3326.MOV,250,438,412,500,618,12,0,206
IMG_3326.MOV,251,438,414,500,621,12,0,207
IMG_3326.MOV,252,438,414,501,621,12,1,207
IMG_3326.MOV,277,366,385,429,596,12,0,211
IMG_3326.MOV,278,366,386,427,591,12,0,205
IMG_3326.MOV,279,366,386,426,590,12,0,204
IMG_3326.MOV,280,365,387,426,590,12,0,203
IMG_3326.MOV,281,364,389,423,589,12,0,200
IMG_3326.MOV,282,362,391,420,587,12,0,196
IMG_3326.MOV,283,360,391,418,586,12,0,195
IMG_3326.MOV,284,359,391,417,586,12,0,195
IMG_3326.MOV,285,359,391,417,585,12,0,194
IMG_3326.MOV,286,358,392,416,583,12,0,191
IMG_3326.MOV,287,358,392,415,581,12,0,189
IMG_3326.MOV,288,357,392,414,578,12,0,186
IMG_3326.MOV,289,356,393,412,572,12,0,179
IMG_3326.MOV,290,356,393,412,570,12,0,177
IMG_3326.MOV,291,354,391,411,571,12,0,180
IMG_3326.MOV,292,353,391,411,572,12,0,181
IMG_3326.MOV,293,351,389,411,574,12,0,185
IMG_3326.MOV,294,351,389,411,575,12,0,186
IMG_3326.MOV,295,350,388,410,575,12,0,187
IMG_3326.MOV,296,349,388,409,573,12,0,185
IMG_3326.MOV,297,349,386,409,573,12,0,187
IMG_3326.MOV,298,348,385,409,575,12,0,190
IMG_3326.MOV,299,346,384,409,577,12,0,193
IMG_3326.MOV,300,345,383,408,577,12,0,194
IMG_3326.MOV,301,344,383,407,579,12,0,196
IMG_3326.MOV,302,343,382,406,580,12,0,198
IMG_3326.MOV,303,343,383,406,580,12,0,197
IMG_3326.MOV,304,342,382,405,580,12,0,198
IMG_3326.MOV,305,343,383,405,577,12,0,194
IMG_3326.MOV,306,335,383,397,575,12,0,192
IMG_3326.MOV,307,332,385,394,573,12,0,188
IMG_3326.MOV,308,331,386,393,572,12,0,186
IMG_3326.MOV,309,330,386,392,570,12,0,184
IMG_3326.MOV,310,329,386,392,571,12,0,185
IMG_3326.MOV,311,329,386,392,571,12,0,185
IMG_3326.MOV,312,328,386,390,570,12,1,184
IMG_3326.MOV,315,336,386,382,514,12,0,128
IMG_3326.MOV,316,335,386,381,508,12,0,122
IMG_3326.MOV,317,334,385,381,508,12,0,123
IMG_3326.MOV,318,333,385,381,508,12,0,123
IMG_3326.MOV,319,332,384,381,507,12,0,123
IMG_3326.MOV,320,331,383,380,505,12,0,122
IMG_3326.MOV,321,330,383,380,504,12,0,121
IMG_3326.MOV,322,329,383,380,504,12,0,121
IMG_3326.MOV,323,328,382,380,504,12,0,122
IMG_3326.MOV,324,327,381,379,503,12,0,122
IMG_3326.MOV,325,325,380,378,503,12,0,123
IMG_3326.MOV,326,324,379,378,503,12,0,124
IMG_3326.MOV,327,323,379,377,503,12,0,124
IMG_3326.MOV,328,323,379,377,504,12,0,125
IMG_3326.MOV,329,321,379,376,505,12,0,126
IMG_3326.MOV,330,320,379,376,506,12,0,127
IMG_3326.MOV,331,320,379,376,507,12,0,128
IMG_3326.MOV,332,319,379,375,507,12,0,128
IMG_3326.MOV,333,318,381,375,510,12,0,129
IMG_3326.MOV,334,317,381,375,511,12,0,130
IMG_3326.MOV,335,316,381,374,511,12,0,130
IMG_3326.MOV,336,314,381,373,511,12,0,130
IMG_3326.MOV,337,313,381,372,511,12,1,130
IMG_3326.MOV,347,287,387,374,587,12,0,200
IMG_3326.MOV,348,288,388,373,591,12,0,203
IMG_3326.MOV,349,288,387,372,593,12,0,206
IMG_3326.MOV,350,288,384,372,594,12,0,210
IMG_3326.MOV,351,287,382,370,596,12,0,214
IMG_3326.MOV,352,286,382,367,595,12,0,213
IMG_3326.MOV,353,286,382,366,596,12,0,214
IMG_3326.MOV,354,284,386,362,594,12,0,208
IMG_3326.MOV,355,281,392,357,588,12,0,196
IMG_3326.MOV,356,279,393,356,591,12,1,198
IMG_3326.MOV,358,280,393,355,586,12,0,193
IMG_3326.MOV,359,278,394,354,588,12,1,194
IMG_3326.MOV,365,280,381,366,605,12,0,224
IMG_3326.MOV,366,280,378,366,606,12,0,228
IMG_3326.MOV,367,280,376,366,608,12,0,232
IMG_3326.MOV,368,280,377,365,607,12,0,230
IMG_3326.MOV,369,281,376,365,607,12,0,231
IMG_3326.MOV,370,282,377,365,606,12,0,229
IMG_3326.MOV,371,282,381,363,605,12,0,224
IMG_3326.MOV,372,281,381,363,606,12,1,225
IMG_3326.MOV,398,192,413,235,532,12,0,119
IMG_3326.MOV,399,191,412,233,530,12,0,118
IMG_3326.MOV,400,190,412,232,530,12,0,118
IMG_3326.MOV,401,190,412,231,531,12,0,119
IMG_3326.MOV,402,190,414,231,531,12,0,117
IMG_3326.MOV,403,190,415,231,531,12,0,116
IMG_3326.MOV,404,190,416,230,531,12,0,115
IMG_3326.MOV,405,189,415,230,532,12,0,117
IMG_3326.MOV,406,189,416,230,531,12,0,115
IMG_3326.MOV,407,189,416,230,531,12,0,115
IMG_3326.MOV,408,189,416,229,531,12,0,115
IMG_3326.MOV,409,188,417,228,531,12,0,114
IMG_3326.MOV,410,189,420,228,531,12,0,111
IMG_3326.MOV,411,189,421,227,530,12,1,109
IMG_3326.MOV,1,586,479,641,621,13,0,142
IMG_3326.MOV,2,587,483,640,618,13,1,135
IMG_3326.MOV,1,542,435,583,595,14,0,160
IMG_3326.MOV,2,543,437,583,592,14,1,155
IMG_3326.MOV,7,582,435,637,618,15,0,183
IMG_3326.MOV,8,580,436,636,620,15,0,184
IMG_3326.MOV,9,580,437,636,622,15,0,185
IMG_3326.MOV,10,579,437,635,622,15,0,185
IMG_3326.MOV,11,578,436,636,623,15,0,187
IMG_3326.MOV,12,577,434,636,625,15,0,191
IMG_3326.MOV,13,576,434,636,626,15,0,192
IMG_3326.MOV,14,575,432,636,626,15,0,194
IMG_3326.MOV,15,574,430,637,626,15,0,196
IMG_3326.MOV,16,573,429,636,626,15,0,197
IMG_3326.MOV,17,573,431,635,625,15,0,194
IMG_3326.MOV,18,572,430,635,626,15,0,196
IMG_3326.MOV,19,572,429,635,627,15,0,198
IMG_3326.MOV,20,572,430,634,626,15,0,196
IMG_3326.MOV,21,571,431,633,626,15,0,195
IMG_3326.MOV,22,572,432,633,623,15,0,191
IMG_3326.MOV,23,572,434,633,621,15,0,187
IMG_3326.MOV,24,572,434,633,619,15,0,185
IMG_3326.MOV,25,572,434,633,619,15,0,185
IMG_3326.MOV,26,572,434,633,618,15,0,184
IMG_3326.MOV,27,572,432,633,614,15,0,182
IMG_3326.MOV,28,572,430,632,613,15,0,183
IMG_3326.MOV,29,572,430,632,613,15,0,183
IMG_3326.MOV,30,571,429,631,612,15,1,183
IMG_3326.MOV,31,568,425,632,619,15,0,194
IMG_3326.MOV,32,568,424,631,619,15,0,195
IMG_3326.MOV,33,568,427,630,617,15,0,190
IMG_3326.MOV,34,568,429,629,617,15,0,188
IMG_3326.MOV,35,567,431,628,618,15,0,187
IMG_3326.MOV,36,566,431,627,617,15,0,186
IMG_3326.MOV,37,566,431,627,617,15,0,186
IMG_3326.MOV,38,566,432,626,614,15,0,182
IMG_3326.MOV,39,566,434,626,613,15,0,179
IMG_3326.MOV,40,565,434,626,613,15,0,179
IMG_3326.MOV,41,565,432,626,615,15,0,183
IMG_3326.MOV,42,564,432,626,617,15,0,185
IMG_3326.MOV,43,564,433,626,617,15,0,184
IMG_3326.MOV,44,563,433,625,618,15,0,185
IMG_3326.MOV,45,557,435,618,616,15,0,181
IMG_3326.MOV,46,554,438,614,614,15,0,176
IMG_3326.MOV,47,553,441,612,613,15,0,172
IMG_3326.MOV,48,553,446,610,611,15,0,165
IMG_3326.MOV,49,553,448,609,609,15,0,161
IMG_3326.MOV,50,552,447,609,608,15,0,161
IMG_3326.MOV,51,551,446,609,608,15,0,162
IMG_3326.MOV,52,550,444,609,608,15,0,164
IMG_3326.MOV,53,548,440,608,609,15,0,169
IMG_3326.MOV,54,547,440,607,609,15,0,169
IMG_3326.MOV,55,547,440,608,610,15,0,170
IMG_3326.MOV,56,546,438,607,610,15,0,172
IMG_3326.MOV,57,545,437,608,611,15,0,174
IMG_3326.MOV,58,544,435,607,609,15,0,174
IMG_3326.MOV,59,542,431,607,609,15,0,178
IMG_3326.MOV,60,541,430,607,610,15,0,180
IMG_3326.MOV,61,541,429,607,610,15,0,181
IMG_3326.MOV,62,541,430,607,611,15,0,181
IMG_3326.MOV,63,540,430,606,611,15,0,181
IMG_3326.MOV,64,540,431,605,611,15,0,180
IMG_3326.MOV,65,540,430,604,609,15,0,179
IMG_3326.MOV,66,540,430,603,607,15,0,177
IMG_3326.MOV,67,539,429,602,609,15,0,180
IMG_3326.MOV,68,539,428,602,609,15,0,181
IMG_3326.MOV,69,539,427,601,609,15,1,182
IMG_3326.MOV,52,387,389,446,574,17,0,185
IMG_3326.MOV,53,386,386,445,575,17,0,189
IMG_3326.MOV,54,386,385,445,574,17,0,189
IMG_3326.MOV,55,386,385,444,574,17,0,189
IMG_3326.MOV,56,385,386,442,571,17,0,185
IMG_3326.MOV,57,385,386,440,569,17,0,183
IMG_3326.MOV,58,384,386,439,567,17,0,181
IMG_3326.MOV,59,384,385,438,566,17,0,181
IMG_3326.MOV,60,384,385,438,564,17,0,179
IMG_3326.MOV,61,384,386,437,562,17,0,176
IMG_3326.MOV,62,384,386,436,561,17,0,175
IMG_3326.MOV,63,383,385,436,561,17,0,176
IMG_3326.MOV,64,384,385,437,561,17,0,176
IMG_3326.MOV,65,383,385,436,562,17,0,177
IMG_3326.MOV,66,376,383,430,562,17,0,179
IMG_3326.MOV,67,372,382,427,562,17,0,180
IMG_3326.MOV,68,371,382,427,563,17,0,181
IMG_3326.MOV,69,370,381,426,565,17,0,184
IMG_3326.MOV,70,369,383,427,567,17,0,184
IMG_3326.MOV,71,368,384,426,567,17,0,183
IMG_3326.MOV,72,368,384,426,567,17,0,183
IMG_3326.MOV,73,368,384,426,567,17,0,183
IMG_3326.MOV,74,368,383,427,567,17,0,184
IMG_3326.MOV,75,367,383,427,568,17,0,185
IMG_3326.MOV,76,367,384,428,569,17,0,185
IMG_3326.MOV,77,366,386,427,569,17,0,183
IMG_3326.MOV,78,365,387,426,567,17,0,180
IMG_3326.MOV,79,364,388,425,568,17,0,180
IMG_3326.MOV,80,363,388,425,568,17,0,180
IMG_3326.MOV,81,362,389,422,569,17,0,180
IMG_3326.MOV,82,361,388,422,569,17,0,181
IMG_3326.MOV,83,360,389,421,569,17,0,180
IMG_3326.MOV,84,359,389,420,569,17,0,180
IMG_3326.MOV,85,358,388,419,570,17,0,182
IMG_3326.MOV,86,357,388,419,570,17,0,182
IMG_3326.MOV,87,355,388,416,569,17,0,181
IMG_3326.MOV,88,355,387,415,568,17,0,181
IMG_3326.MOV,89,354,387,414,568,17,0,181
IMG_3326.MOV,90,352,386,412,567,17,0,181
IMG_3326.MOV,91,350,385,411,567,17,0,182
IMG_3326.MOV,92,349,385,409,567,17,0,182
IMG_3326.MOV,93,348,385,408,567,17,0,182
IMG_3326.MOV,94,347,384,408,569,17,0,185
IMG_3326.MOV,95,346,384,407,569,17,0,185
IMG_3326.MOV,96,345,384,405,567,17,0,183
IMG_3326.MOV,97,344,385,404,567,17,0,182
IMG_3326.MOV,98,344,386,403,566,17,0,180
IMG_3326.MOV,99,344,386,402,565,17,0,179
IMG_3326.MOV,100,336,384,395,564,17,0,180
IMG_3326.MOV,101,332,384,391,563,17,0,179
IMG_3326.MOV,102,331,384,390,563,17,0,179
IMG_3326.MOV,103,331,385,389,562,17,0,177
IMG_3326.MOV,104,331,385,389,563,17,0,178
IMG_3326.MOV,105,331,387,388,562,17,0,175
IMG_3326.MOV,106,331,387,387,561,17,0,174
IMG_3326.MOV,107,331,387,386,561,17,0,174
IMG_3326.MOV,108,331,387,386,561,17,0,174
IMG_3326.MOV,109,331,387,386,562,17,0,175
IMG_3326.MOV,110,332,388,386,561,17,0,173
IMG_3326.MOV,111,331,390,385,561,17,0,171
IMG_3326.MOV,112,331,391,384,563,17,0,172
IMG_3326.MOV,113,330,392,384,565,17,0,173
IMG_3326.MOV,114,331,397,382,565,17,0,168
IMG_3326.MOV,115,330,398,381,565,17,1,167
IMG_3326.MOV,133,369,407,423,578,17,0,171
IMG_3326.MOV,134,371,407,425,579,17,0,172
IMG_3326.MOV,135,373,408,426,579,17,1,171
IMG_3326.MOV,141,370,411,423,578,17,0,167
IMG_3326.MOV,142,370,411,424,578,17,1,167
IMG_3326.MOV,150,302,385,346,506,17,0,121
IMG_3326.MOV,151,297,383,344,504,17,0,121
IMG_3326.MOV,152,292,382,343,506,17,0,124
IMG_3326.MOV,153,290,383,342,507,17,0,124
IMG_3326.MOV,154,290,384,343,508,17,0,124
IMG_3326.MOV,155,287,383,339,505,17,1,122
IMG_3326.MOV,174,274,380,334,526,17,0,146
IMG_3326.MOV,175,274,380,332,527,17,0,147
IMG_3326.MOV,176,274,380,331,526,17,0,146
IMG_3326.MOV,177,274,381,330,525,17,0,144
IMG_3326.MOV,178,273,381,329,524,17,0,143
IMG_3326.MOV,179,273,382,330,523,17,0,141
IMG_3326.MOV,180,272,382,329,523,17,0,141
IMG_3326.MOV,181,272,382,330,524,17,0,142
IMG_3326.MOV,182,271,382,331,526,17,0,144
IMG_3326.MOV,183,270,381,333,529,17,0,148
IMG_3326.MOV,184,269,381,334,532,17,0,151
IMG_3326.MOV,185,267,382,339,551,17,0,169
IMG_3326.MOV,186,265,382,343,561,17,0,179
IMG_3326.MOV,187,267,381,338,542,17,0,161
IMG_3326.MOV,188,267,380,336,535,17,0,155
IMG_3326.MOV,189,264,382,342,555,17,0,173
IMG_3326.MOV,190,257,378,330,543,17,0,165
IMG_3326.MOV,191,254,376,324,537,17,0,161
IMG_3326.MOV,192,252,376,320,534,17,0,158
IMG_3326.MOV,193,253,376,319,533,17,0,157
IMG_3326.MOV,194,253,375,317,531,17,0,156
IMG_3326.MOV,195,253,374,316,530,17,0,156
IMG_3326.MOV,196,252,375,315,531,17,0,156
IMG_3326.MOV,197,252,375,313,530,17,0,155
IMG_3326.MOV,198,251,376,312,531,17,0,155
IMG_3326.MOV,199,250,376,310,531,17,0,155
IMG_3326.MOV,200,249,375,309,531,17,0,156
IMG_3326.MOV,201,250,376,307,526,17,0,150
IMG_3326.MOV,202,251,380,303,518,17,0,138
IMG_3326.MOV,203,251,381,301,512,17,0,131
IMG_3326.MOV,204,251,382,299,508,17,0,126
IMG_3326.MOV,205,250,381,298,505,17,0,124
IMG_3326.MOV,206,251,382,297,503,17,0,121
IMG_3326.MOV,207,250,382,298,505,17,0,123
IMG_3326.MOV,208,248,381,297,505,17,0,124
IMG_3326.MOV,209,247,381,295,503,17,0,122
IMG_3326.MOV,210,245,380,293,504,17,0,124
IMG_3326.MOV,211,243,378,293,507,17,0,129
IMG_3326.MOV,212,242,377,293,509,17,0,132
IMG_3326.MOV,213,242,377,291,508,17,0,131
IMG_3326.MOV,214,242,378,290,506,17,0,128
IMG_3326.MOV,215,241,380,287,502,17,0,122
IMG_3326.MOV,216,241,381,286,499,17,0,118
IMG_3326.MOV,217,241,381,286,499,17,0,118
IMG_3326.MOV,218,241,384,285,497,17,0,113
IMG_3326.MOV,219,240,384,285,498,17,0,114
IMG_3326.MOV,220,240,384,284,497,17,1,113
IMG_3326.MOV,222,229,381,275,496,17,0,115
IMG_3326.MOV,223,226,380,273,496,17,0,116
IMG_3326.MOV,224,225,380,271,495,17,1,115
IMG_3326.MOV,230,222,379,271,497,17,0,118
IMG_3326.MOV,231,220,377,270,499,17,0,122
IMG_3326.MOV,232,218,377,269,500,17,0,123
IMG_3326.MOV,233,222,375,263,472,17,0,97
IMG_3326.MOV,234,218,378,267,493,17,0,115
IMG_3326.MOV,235,214,378,267,501,17,0,123
IMG_3326.MOV,236,213,378,266,502,17,1,124
IMG_3326.MOV,260,403,392,447,492,17,0,100
IMG_3326.MOV,261,405,392,450,491,17,0,99
IMG_3326.MOV,262,406,392,451,491,17,0,99
IMG_3326.MOV,263,404,392,450,489,17,0,97
IMG_3326.MOV,264,402,392,450,491,17,0,99
IMG_3326.MOV,265,399,393,450,492,17,0,99
IMG_3326.MOV,266,396,393,447,493,17,0,100
IMG_3326.MOV,267,393,394,445,494,17,0,100
IMG_3326.MOV,268,395,395,447,494,17,1,99
IMG_3326.MOV,275,369,390,429,511,17,0,121
IMG_3326.MOV,276,368,390,429,512,17,1,122
IMG_3326.MOV,156,284,381,349,595,18,0,214
IMG_3326.MOV,157,282,381,348,595,18,0,214
IMG_3326.MOV,158,282,381,348,595,18,0,214
IMG_3326.MOV,159,280,379,347,595,18,0,216
IMG_3326.MOV,160,279,378,346,596,18,0,218
IMG_3326.MOV,161,279,378,346,596,18,0,218
IMG_3326.MOV,162,278,377,346,595,18,0,218
IMG_3326.MOV,163,277,375,345,595,18,0,220
IMG_3326.MOV,164,277,375,344,594,18,0,219
IMG_3326.MOV,165,278,376,343,590,18,0,214
IMG_3326.MOV,166,277,376,342,588,18,0,212
IMG_3326.MOV,167,276,375,341,589,18,0,214
IMG_3326.MOV,168,275,375,340,590,18,0,215
IMG_3326.MOV,169,274,376,338,588,18,0,212
IMG_3326.MOV,170,274,377,337,586,18,0,209
IMG_3326.MOV,171,274,378,336,585,18,0,207
IMG_3326.MOV,172,275,380,336,585,18,0,205
IMG_3326.MOV,173,275,380,336,584,18,0,204
IMG_3326.MOV,174,275,380,335,584,18,1,204
IMG_3326.MOV,177,493,405,555,498,19,0,93
IMG_3326.MOV,178,492,405,554,498,19,0,93
IMG_3326.MOV,179,492,405,553,498,19,1,93
IMG_3326.MOV,181,1579,573,1685,908,20,0,335
IMG_3326.MOV,182,1578,570,1686,913,20,0,343
IMG_3326.MOV,183,1579,568,1688,915,20,0,347
IMG_3326.MOV,184,1579,566,1689,916,20,0,350
IMG_3326.MOV,185,1579,565,1690,918,20,1,353
IMG_3326.MOV,187,1584,579,1689,911,20,0,332
IMG_3326.MOV,188,1585,584,1687,906,20,0,322
IMG_3326.MOV,189,1586,585,1688,906,20,1,321
IMG_3326.MOV,192,1587,579,1691,903,20,0,324
IMG_3326.MOV,193,1585,571,1693,907,20,0,336
IMG_3326.MOV,194,1586,570,1695,909,20,0,339
IMG_3326.MOV,195,1586,571,1696,907,20,0,336
IMG_3326.MOV,196,1587,571,1698,907,20,0,336
IMG_3326.MOV,197,1589,569,1700,907,20,0,338
IMG_3326.MOV,198,1588,567,1702,911,20,0,344
IMG_3326.MOV,199,1590,572,1701,906,20,0,334
IMG_3326.MOV,200,1590,571,1702,908,20,0,337
IMG_3326.MOV,201,1589,568,1703,912,20,0,344
IMG_3326.MOV,202,1587,562,1704,916,20,0,354
IMG_3326.MOV,203,1586,556,1705,916,20,0,360
IMG_3326.MOV,204,1586,553,1706,916,20,0,363
IMG_3326.MOV,205,1585,552,1705,918,20,0,366
IMG_3326.MOV,206,1585,552,1706,919,20,0,367
IMG_3326.MOV,207,1587,555,1706,917,20,0,362
IMG_3326.MOV,208,1588,558,1704,914,20,0,356
IMG_3326.MOV,209,1590,557,1705,912,20,0,355
IMG_3326.MOV,210,1591,558,1705,910,20,0,352
IMG_3326.MOV,211,1593,559,1705,907,20,0,348
IMG_3326.MOV,212,1594,559,1704,905,20,0,346
IMG_3326.MOV,213,1594,560,1703,903,20,0,343
IMG_3326.MOV,214,1593,560,1702,904,20,0,344
IMG_3326.MOV,215,1592,561,1700,906,20,0,345
IMG_3326.MOV,216,1591,563,1698,906,20,0,343
IMG_3326.MOV,217,1590,563,1698,906,20,0,343
IMG_3326.MOV,218,1590,563,1697,906,20,0,343
IMG_3326.MOV,219,1590,562,1697,906,20,0,344
IMG_3326.MOV,220,1591,560,1697,905,20,0,345
IMG_3326.MOV,221,1591,560,1698,904,20,0,344
IMG_3326.MOV,222,1591,559,1697,903,20,0,344
IMG_3326.MOV,223,1591,558,1698,903,20,0,345
IMG_3326.MOV,224,1592,558,1698,903,20,0,345
IMG_3326.MOV,225,1592,558,1698,904,20,0,346
IMG_3326.MOV,226,1592,560,1697,904,20,0,344
IMG_3326.MOV,227,1592,560,1697,905,20,0,345
IMG_3326.MOV,228,1592,560,1697,905,20,0,345
IMG_3326.MOV,229,1592,560,1697,906,20,0,346
IMG_3326.MOV,230,1592,561,1698,906,20,0,345
IMG_3326.MOV,231,1592,561,1697,906,20,0,345
IMG_3326.MOV,232,1592,561,1698,906,20,0,345
IMG_3326.MOV,233,1592,561,1698,906,20,0,345
IMG_3326.MOV,234,1593,562,1699,907,20,0,345
IMG_3326.MOV,235,1592,562,1698,908,20,0,346
IMG_3326.MOV,236,1592,563,1699,909,20,0,346
IMG_3326.MOV,237,1593,563,1699,909,20,0,346
IMG_3326.MOV,238,1593,563,1700,909,20,0,346
IMG_3326.MOV,239,1594,565,1700,911,20,0,346
IMG_3326.MOV,240,1594,566,1701,911,20,0,345
IMG_3326.MOV,241,1594,566,1701,912,20,0,346
IMG_3326.MOV,242,1594,565,1701,912,20,0,347
IMG_3326.MOV,243,1594,565,1701,912,20,0,347
IMG_3326.MOV,244,1594,565,1701,913,20,0,348
IMG_3326.MOV,245,1594,565,1701,915,20,0,350
IMG_3326.MOV,246,1594,565,1701,917,20,0,352
IMG_3326.MOV,247,1595,565,1703,918,20,0,353
IMG_3326.MOV,248,1595,564,1703,918,20,0,354
IMG_3326.MOV,249,1595,564,1703,918,20,0,354
IMG_3326.MOV,250,1595,564,1703,917,20,0,353
IMG_3326.MOV,251,1596,564,1703,917,20,0,353
IMG_3326.MOV,252,1595,564,1703,917,20,0,353
IMG_3326.MOV,253,1596,564,1703,915,20,0,351
IMG_3326.MOV,254,1596,565,1703,914,20,0,349
IMG_3326.MOV,255,1596,566,1702,913,20,0,347
IMG_3326.MOV,256,1596,565,1703,914,20,0,349
IMG_3326.MOV,257,1596,565,1704,915,20,0,350
IMG_3326.MOV,258,1596,566,1703,917,20,0,351
IMG_3326.MOV,259,1595,566,1702,918,20,0,352
IMG_3326.MOV,260,1595,565,1702,917,20,0,352
IMG_3326.MOV,261,1595,565,1701,916,20,0,351
IMG_3326.MOV,262,1596,565,1700,914,20,0,349
IMG_3326.MOV,263,1597,566,1700,912,20,0,346
IMG_3326.MOV,264,1597,567,1699,910,20,0,343
IMG_3326.MOV,265,1597,568,1698,910,20,0,342
IMG_3326.MOV,266,1598,567,1699,911,20,0,344
IMG_3326.MOV,267,1598,567,1699,911,20,0,344
IMG_3326.MOV,268,1598,568,1698,910,20,0,342
IMG_3326.MOV,269,1599,567,1698,910,20,0,343
IMG_3326.MOV,270,1600,566,1699,909,20,0,343
IMG_3326.MOV,271,1601,564,1700,908,20,0,344
IMG_3326.MOV,272,1601,564,1700,907,20,0,343
IMG_3326.MOV,273,1601,564,1700,909,20,0,345
IMG_3326.MOV,274,1601,565,1700,911,20,0,346
IMG_3326.MOV,275,1601,565,1700,911,20,0,346
IMG_3326.MOV,276,1601,565,1700,910,20,0,345
IMG_3326.MOV,277,1601,566,1700,910,20,0,344
IMG_3326.MOV,278,1601,566,1699,911,20,0,345
IMG_3326.MOV,279,1602,567,1700,913,20,0,346
IMG_3326.MOV,280,1602,567,1700,912,20,0,345
IMG_3326.MOV,281,1602,568,1700,910,20,0,342
IMG_3326.MOV,282,1603,569,1700,910,20,0,341
IMG_3326.MOV,283,1603,569,1701,910,20,0,341
IMG_3326.MOV,284,1603,569,1701,910,20,1,341
IMG_3326.MOV,287,1587,581,1700,971,20,0,390
IMG_3326.MOV,288,1586,582,1700,976,20,1,394
IMG_3326.MOV,289,1584,579,1701,979,20,0,400
IMG_3326.MOV,290,1583,580,1701,985,20,1,405
IMG_3326.MOV,291,1598,571,1704,935,20,0,364
IMG_3326.MOV,292,1601,569,1703,920,20,0,351
IMG_3326.MOV,293,1603,568,1704,914,20,0,346
IMG_3326.MOV,294,1602,566,1706,918,20,0,352
IMG_3326.MOV,295,1602,566,1706,919,20,0,353
IMG_3326.MOV,296,1602,566,1706,919,20,0,353
IMG_3326.MOV,297,1602,566,1707,921,20,0,355
IMG_3326.MOV,298,1602,571,1706,919,20,0,348
IMG_3326.MOV,299,1600,573,1703,918,20,0,345
IMG_3326.MOV,300,1599,571,1703,919,20,0,348
IMG_3326.MOV,301,1598,571,1702,920,20,0,349
IMG_3326.MOV,302,1599,570,1702,920,20,0,350
IMG_3326.MOV,303,1599,570,1702,920,20,0,350
IMG_3326.MOV,304,1599,568,1703,921,20,0,353
IMG_3326.MOV,305,1600,568,1704,921,20,0,353
IMG_3326.MOV,306,1601,568,1706,921,20,0,353
IMG_3326.MOV,307,1602,568,1706,921,20,0,353
IMG_3326.MOV,308,1603,571,1706,919,20,0,348
IMG_3326.MOV,309,1604,575,1705,914,20,0,339
IMG_3326.MOV,310,1605,576,1705,913,20,1,337
IMG_3326.MOV,206,292,402,353,566,21,0,164
IMG_3326.MOV,207,292,403,353,565,21,0,162
IMG_3326.MOV,208,291,401,354,567,21,0,166
IMG_3326.MOV,209,291,401,354,567,21,0,166
IMG_3326.MOV,210,290,402,352,565,21,0,163
IMG_3326.MOV,211,288,402,351,564,21,0,162
IMG_3326.MOV,212,286,402,348,564,21,0,162
IMG_3326.MOV,213,284,402,347,564,21,0,162
IMG_3326.MOV,214,282,403,345,564,21,0,161
IMG_3326.MOV,215,280,403,344,564,21,0,161
IMG_3326.MOV,216,280,405,344,564,21,0,159
IMG_3326.MOV,217,280,405,344,564,21,0,159
IMG_3326.MOV,218,281,405,345,563,21,0,158
IMG_3326.MOV,219,281,405,346,561,21,0,156
IMG_3326.MOV,220,281,405,347,560,21,0,155
IMG_3326.MOV,221,282,405,348,560,21,0,155
IMG_3326.MOV,222,282,405,349,562,21,0,157
IMG_3326.MOV,223,281,405,349,562,21,0,157
IMG_3326.MOV,224,281,406,350,566,21,0,160
IMG_3326.MOV,225,282,406,352,568,21,0,162
IMG_3326.MOV,226,283,406,353,571,21,0,165
IMG_3326.MOV,227,285,408,353,570,21,0,162
IMG_3326.MOV,228,287,410,352,565,21,0,155
IMG_3326.MOV,229,287,410,351,563,21,0,153
IMG_3326.MOV,230,285,409,350,561,21,0,152
IMG_3326.MOV,231,282,406,348,561,21,0,155
IMG_3326.MOV,232,281,404,349,562,21,0,158
IMG_3326.MOV,233,281,405,350,564,21,0,159
IMG_3326.MOV,234,281,405,349,562,21,0,157
IMG_3326.MOV,235,282,406,350,561,21,0,155
IMG_3326.MOV,236,285,408,351,559,21,0,151
IMG_3326.MOV,237,285,408,351,557,21,0,149
IMG_3326.MOV,238,287,410,351,555,21,0,145
IMG_3326.MOV,239,290,414,351,552,21,0,138
IMG_3326.MOV,240,291,417,352,556,21,0,139
IMG_3326.MOV,241,291,418,352,558,21,0,140
IMG_3326.MOV,242,292,420,351,556,21,0,136
IMG_3326.MOV,243,292,421,351,557,21,0,136
IMG_3326.MOV,244,293,425,350,555,21,0,130
IMG_3326.MOV,245,294,427,348,552,21,0,125
IMG_3326.MOV,246,293,428,348,554,21,0,126
IMG_3326.MOV,247,292,426,349,557,21,0,131
IMG_3326.MOV,248,292,426,350,558,21,0,132
IMG_3326.MOV,249,292,427,350,559,21,0,132
IMG_3326.MOV,250,291,423,351,563,21,0,140
IMG_3326.MOV,251,291,422,351,562,21,0,140
IMG_3326.MOV,252,291,420,352,562,21,0,142
IMG_3326.MOV,253,291,419,353,565,21,0,146
IMG_3326.MOV,254,291,418,353,566,21,0,148
IMG_3326.MOV,255,291,420,351,564,21,0,144
IMG_3326.MOV,256,292,421,350,559,21,0,138
IMG_3326.MOV,257,293,421,351,559,21,0,138
IMG_3326.MOV,258,294,423,350,558,21,0,135
IMG_3326.MOV,259,294,421,350,556,21,0,135
IMG_3326.MOV,260,293,420,350,555,21,0,135
IMG_3326.MOV,261,293,418,350,554,21,0,136
IMG_3326.MOV,262,294,418,350,553,21,0,135
IMG_3326.MOV,263,294,419,351,555,21,0,136
IMG_3326.MOV,264,294,419,352,557,21,0,138
IMG_3326.MOV,265,293,421,351,557,21,0,136
IMG_3326.MOV,266,294,423,351,557,21,0,134
IMG_3326.MOV,267,294,422,351,557,21,0,135
IMG_3326.MOV,268,294,422,352,557,21,0,135
IMG_3326.MOV,269,294,422,352,557,21,1,135
IMG_3326.MOV,295,291,426,348,548,21,0,122
IMG_3326.MOV,296,290,425,350,547,21,0,122
IMG_3326.MOV,297,289,425,352,549,21,0,124
IMG_3326.MOV,298,288,422,352,549,21,0,127
IMG_3326.MOV,299,285,416,353,550,21,0,134
IMG_3326.MOV,300,284,414,353,550,21,0,136
IMG_3326.MOV,301,284,413,353,550,21,1,137
IMG_3326.MOV,321,288,429,348,545,21,0,116
IMG_3326.MOV,322,287,430,347,546,21,0,116
IMG_3326.MOV,323,288,431,347,545,21,0,114
IMG_3326.MOV,324,287,431,347,545,21,0,114
IMG_3326.MOV,325,287,430,348,546,21,0,116
IMG_3326.MOV,326,287,430,348,546,21,0,116
IMG_3326.MOV,327,288,430,347,542,21,0,112
IMG_3326.MOV,328,288,431,347,542,21,1,111
IMG_3326.MOV,236,181,458,244,602,22,0,144
IMG_3326.MOV,237,181,458,244,603,22,0,145
IMG_3326.MOV,238,179,457,243,604,22,0,147
IMG_3326.MOV,239,180,456,244,604,22,0,148
IMG_3326.MOV,240,179,455,244,604,22,1,149
IMG_3326.MOV,241,178,448,247,608,22,0,160
IMG_3326.MOV,242,177,446,247,609,22,1,163
IMG_3326.MOV,248,198,452,262,604,22,0,152
IMG_3326.MOV,249,203,455,263,602,22,0,147
IMG_3326.MOV,250,206,455,265,601,22,0,146
IMG_3326.MOV,251,188,456,247,603,22,0,147
IMG_3326.MOV,252,181,456,242,605,22,0,149
IMG_3326.MOV,253,177,454,239,607,22,0,153
IMG_3326.MOV,254,175,451,240,611,22,0,160
IMG_3326.MOV,255,174,451,239,612,22,0,161
IMG_3326.MOV,256,175,450,239,611,22,0,161
IMG_3326.MOV,257,175,449,239,611,22,0,162
IMG_3326.MOV,258,176,449,239,610,22,0,161
IMG_3326.MOV,259,176,449,239,609,22,0,160
IMG_3326.MOV,260,176,448,240,609,22,0,161
IMG_3326.MOV,261,175,449,240,609,22,0,160
IMG_3326.MOV,262,175,446,241,609,22,0,163
IMG_3326.MOV,263,175,446,243,608,22,0,162
IMG_3326.MOV,264,174,445,243,608,22,0,163
IMG_3326.MOV,265,173,445,244,610,22,0,165
IMG_3326.MOV,266,172,444,245,613,22,0,169
IMG_3326.MOV,267,172,443,245,614,22,0,171
IMG_3326.MOV,268,172,442,246,617,22,0,175
IMG_3326.MOV,269,170,436,248,619,22,0,183
IMG_3326.MOV,270,169,431,249,619,22,0,188
IMG_3326.MOV,271,169,429,249,619,22,0,190
IMG_3326.MOV,272,170,431,248,617,22,0,186
IMG_3326.MOV,273,171,434,247,615,22,0,181
IMG_3326.MOV,274,172,435,247,615,22,0,180
IMG_3326.MOV,275,173,436,247,613,22,0,177
IMG_3326.MOV,276,173,435,247,612,22,0,177
IMG_3326.MOV,277,173,434,247,612,22,1,178
IMG_3326.MOV,278,172,431,249,613,22,0,182
IMG_3326.MOV,279,172,430,249,615,22,0,185
IMG_3326.MOV,280,172,430,249,615,22,1,185
IMG_3326.MOV,282,175,435,249,612,22,0,177
IMG_3326.MOV,283,179,444,247,608,22,0,164
IMG_3326.MOV,284,181,449,245,605,22,0,156
IMG_3326.MOV,285,182,452,244,603,22,0,151
IMG_3326.MOV,286,183,453,244,603,22,0,150
IMG_3326.MOV,287,184,457,243,602,22,0,145
IMG_3326.MOV,288,184,459,243,603,22,0,144
IMG_3326.MOV,289,185,461,243,602,22,1,141
IMG_3326.MOV,299,186,395,276,612,22,0,217
IMG_3326.MOV,300,186,395,277,613,22,0,218
IMG_3326.MOV,301,190,422,271,613,22,0,191
IMG_3326.MOV,302,190,436,267,613,22,0,177
IMG_3326.MOV,303,191,440,268,614,22,0,174
IMG_3326.MOV,304,189,427,273,615,22,0,188
IMG_3326.MOV,305,188,423,276,618,22,0,195
IMG_3326.MOV,306,187,423,277,619,22,0,196
IMG_3326.MOV,307,190,436,274,617,22,0,181
IMG_3326.MOV,308,189,429,279,619,22,0,190
IMG_3326.MOV,309,189,436,277,619,22,0,183
IMG_3326.MOV,310,189,439,276,620,22,0,181
IMG_3326.MOV,311,190,443,274,618,22,0,175
IMG_3326.MOV,312,191,447,272,616,22,0,169
IMG_3326.MOV,313,192,448,271,616,22,0,168
IMG_3326.MOV,314,192,444,272,616,22,0,172
IMG_3326.MOV,315,195,445,274,614,22,0,169
IMG_3326.MOV,316,197,447,274,612,22,0,165
IMG_3326.MOV,317,199,450,273,609,22,0,159
IMG_3326.MOV,318,200,452,273,609,22,0,157
IMG_3326.MOV,319,201,451,275,610,22,0,159
IMG_3326.MOV,320,202,449,275,609,22,0,160
IMG_3326.MOV,321,203,450,277,610,22,0,160
IMG_3326.MOV,322,203,448,277,612,22,0,164
IMG_3326.MOV,323,201,447,274,610,22,0,163
IMG_3326.MOV,324,202,445,274,609,22,0,164
IMG_3326.MOV,325,209,458,280,619,22,0,161
IMG_3326.MOV,326,207,451,277,613,22,0,162
IMG_3326.MOV,327,206,447,274,607,22,0,160
IMG_3326.MOV,328,206,447,274,606,22,1,159
IMG_3326.MOV,329,225,464,292,622,22,0,158
IMG_3326.MOV,330,229,467,296,627,22,0,160
IMG_3326.MOV,331,232,468,298,630,22,0,162
IMG_3326.MOV,332,233,466,301,634,22,0,168
IMG_3326.MOV,333,233,466,301,636,22,0,170
IMG_3326.MOV,334,234,465,301,637,22,0,172
IMG_3326.MOV,335,235,464,301,637,22,0,173
IMG_3326.MOV,336,236,464,301,635,22,0,171
IMG_3326.MOV,337,235,464,300,635,22,0,171
IMG_3326.MOV,338,234,464,300,636,22,0,172
IMG_3326.MOV,339,235,465,300,637,22,0,172
IMG_3326.MOV,340,236,466,301,637,22,0,171
IMG_3326.MOV,341,236,466,301,637,22,0,171
IMG_3326.MOV,342,235,465,300,638,22,0,173
IMG_3326.MOV,343,234,464,299,638,22,0,174
IMG_3326.MOV,344,233,461,299,636,22,0,175
IMG_3326.MOV,345,234,460,301,635,22,0,175
IMG_3326.MOV,346,236,460,303,636,22,0,176
IMG_3326.MOV,347,237,459,305,636,22,0,177
IMG_3326.MOV,348,238,459,307,637,22,0,178
IMG_3326.MOV,349,239,459,308,636,22,0,177
IMG_3326.MOV,350,239,458,309,636,22,0,178
IMG_3326.MOV,351,240,458,310,636,22,0,178
IMG_3326.MOV,352,239,457,309,637,22,0,180
IMG_3326.MOV,353,237,456,309,638,22,0,182
IMG_3326.MOV,354,237,455,308,639,22,0,184
IMG_3326.MOV,355,237,455,308,639,22,0,184
IMG_3326.MOV,356,237,455,309,640,22,1,185
IMG_3326.MOV,359,240,454,312,639,22,0,185
IMG_3326.MOV,360,241,453,314,638,22,0,185
IMG_3326.MOV,361,241,452,315,638,22,0,186
IMG_3326.MOV,362,241,452,315,639,22,0,187
IMG_3326.MOV,363,240,451,316,641,22,0,190
IMG_3326.MOV,364,240,451,317,641,22,0,190
IMG_3326.MOV,365,240,450,318,639,22,0,189
IMG_3326.MOV,366,239,448,319,640,22,0,192
IMG_3326.MOV,367,240,446,320,641,22,0,195
IMG_3326.MOV,368,241,446,322,641,22,0,195
IMG_3326.MOV,369,241,446,322,642,22,0,196
IMG_3326.MOV,370,242,446,324,643,22,0,197
IMG_3326.MOV,371,244,448,325,643,22,0,195
IMG_3326.MOV,372,246,452,324,641,22,0,189
IMG_3326.MOV,373,247,454,324,641,22,0,187
IMG_3326.MOV,374,248,456,324,641,22,0,185
IMG_3326.MOV,375,250,460,324,640,22,0,180
IMG_3326.MOV,376,251,463,324,640,22,0,177
IMG_3326.MOV,377,260,462,334,642,22,0,180
IMG_3326.MOV,378,265,462,339,642,22,0,180
IMG_3326.MOV,379,268,464,342,642,22,0,178
IMG_3326.MOV,380,270,465,344,640,22,0,175
IMG_3326.MOV,381,271,464,346,639,22,0,175
IMG_3326.MOV,382,270,463,346,639,22,0,176
IMG_3326.MOV,383,272,464,348,639,22,0,175
IMG_3326.MOV,384,275,466,350,639,22,0,173
IMG_3326.MOV,385,276,467,351,639,22,0,172
IMG_3326.MOV,386,278,466,353,639,22,0,173
IMG_3326.MOV,387,280,468,353,637,22,0,169
IMG_3326.MOV,388,281,469,353,638,22,0,169
IMG_3326.MOV,389,281,468,354,640,22,0,172
IMG_3326.MOV,390,280,466,356,642,22,0,176
IMG_3326.MOV,391,281,466,358,643,22,0,177
IMG_3326.MOV,392,281,462,360,647,22,0,185
IMG_3326.MOV,393,281,461,360,647,22,0,186
IMG_3326.MOV,394,279,461,360,649,22,0,188
IMG_3326.MOV,395,280,460,362,650,22,0,190
IMG_3326.MOV,396,282,461,364,650,22,0,189
IMG_3326.MOV,397,282,462,364,650,22,0,188
IMG_3326.MOV,398,282,462,365,651,22,0,189
IMG_3326.MOV,399,284,461,370,655,22,0,194
IMG_3326.MOV,400,284,459,373,657,22,0,198
IMG_3326.MOV,401,285,458,375,658,22,0,200
IMG_3326.MOV,402,284,456,376,658,22,0,202
IMG_3326.MOV,403,284,458,375,658,22,0,200
IMG_3326.MOV,404,284,459,375,658,22,0,199
IMG_3326.MOV,405,283,459,375,659,22,0,200
IMG_3326.MOV,406,284,459,376,659,22,0,200
IMG_3326.MOV,407,284,459,377,659,22,0,200
IMG_3326.MOV,408,284,459,378,659,22,0,200
IMG_3326.MOV,409,283,458,378,659,22,0,201
IMG_3326.MOV,410,283,458,378,658,22,0,200
IMG_3326.MOV,411,283,457,377,657,22,0,200
IMG_3326.MOV,412,283,457,377,657,22,0,200
IMG_3326.MOV,413,284,459,377,657,22,0,198
IMG_3326.MOV,414,286,461,378,656,22,0,195
IMG_3326.MOV,415,288,460,380,655,22,0,195
IMG_3326.MOV,416,288,459,379,653,22,0,194
IMG_3326.MOV,417,288,459,379,653,22,0,194
IMG_3326.MOV,418,288,458,380,654,22,0,196
IMG_3326.MOV,419,293,459,384,653,22,0,194
IMG_3326.MOV,420,296,457,386,653,22,0,196
IMG_3326.MOV,421,299,457,388,650,22,0,193
IMG_3326.MOV,422,300,455,388,649,22,0,194
IMG_3326.MOV,423,300,452,389,648,22,0,196
IMG_3326.MOV,424,304,454,391,649,22,0,195
IMG_3326.MOV,425,306,454,392,649,22,0,195
IMG_3326.MOV,426,308,454,393,651,22,0,197
IMG_3326.MOV,427,308,455,393,652,22,0,197
IMG_3326.MOV,428,308,456,393,653,22,0,197
IMG_3326.MOV,429,308,457,391,653,22,0,196
IMG_3326.MOV,430,308,458,391,653,22,0,195
IMG_3326.MOV,431,309,460,390,653,22,0,193
IMG_3326.MOV,432,309,460,390,653,22,0,193
IMG_3326.MOV,433,309,459,390,653,22,0,194
IMG_3326.MOV,434,308,457,390,652,22,0,195
IMG_3326.MOV,435,308,457,390,652,22,0,195
IMG_3326.MOV,436,309,460,389,650,22,0,190
IMG_3326.MOV,437,310,463,389,649,22,0,186
IMG_3326.MOV,438,311,465,390,650,22,0,185
IMG_3326.MOV,439,312,464,392,650,22,0,186
IMG_3326.MOV,440,314,462,395,653,22,0,191
IMG_3326.MOV,441,315,460,397,653,22,0,193
IMG_3326.MOV,442,316,460,399,653,22,0,193
IMG_3326.MOV,443,318,462,400,653,22,0,191
IMG_3326.MOV,444,320,463,402,653,22,0,190
IMG_3326.MOV,445,330,464,412,653,22,0,189
IMG_3326.MOV,446,335,464,415,652,22,0,188
IMG_3326.MOV,447,336,463,417,652,22,0,189
IMG_3326.MOV,448,337,465,419,652,22,0,187
IMG_3326.MOV,449,339,465,421,652,22,0,187
IMG_3326.MOV,450,341,466,423,653,22,0,187
IMG_3326.MOV,451,339,465,423,656,22,0,191
IMG_3326.MOV,452,338,463,424,657,22,0,194
IMG_3326.MOV,453,338,463,425,658,22,0,195
IMG_3326.MOV,454,337,463,426,659,22,0,196
IMG_3326.MOV,455,337,463,426,661,22,0,198
IMG_3326.MOV,456,337,462,428,666,22,0,204
IMG_3326.MOV,457,336,460,429,667,22,0,207
IMG_3326.MOV,458,338,462,427,662,22,0,200
IMG_3326.MOV,459,338,464,426,661,22,0,197
IMG_3326.MOV,460,339,464,426,662,22,0,198
IMG_3326.MOV,461,341,464,427,662,22,0,198
IMG_3326.MOV,462,343,464,428,662,22,0,198
IMG_3326.MOV,463,344,465,429,663,22,0,198
IMG_3326.MOV,464,348,467,431,664,22,0,197
IMG_3326.MOV,465,350,469,432,664,22,0,195
IMG_3326.MOV,466,349,464,434,668,22,0,204
IMG_3326.MOV,467,348,462,434,671,22,0,209
IMG_3326.MOV,468,347,460,434,673,22,0,213
IMG_3326.MOV,469,345,458,434,677,22,0,219
IMG_3326.MOV,470,345,457,435,679,22,0,222
IMG_3326.MOV,471,345,456,436,679,22,0,223
IMG_3326.MOV,472,344,455,437,683,22,0,228
IMG_3326.MOV,473,342,455,436,683,22,0,228
IMG_3326.MOV,474,343,455,437,681,22,0,226
IMG_3326.MOV,475,346,456,438,678,22,0,222
IMG_3326.MOV,476,349,456,440,674,22,0,218
IMG_3326.MOV,477,350,455,442,673,22,0,218
IMG_3326.MOV,478,351,455,443,673,22,0,218
IMG_3326.MOV,479,354,457,445,673,22,0,216
IMG_3326.MOV,480,356,460,445,672,22,0,212
IMG_3326.MOV,481,357,462,445,673,22,0,211
IMG_3326.MOV,482,356,461,445,673,22,0,212
IMG_3326.MOV,483,357,461,447,675,22,0,214
IMG_3326.MOV,484,358,462,448,678,22,0,216
IMG_3326.MOV,485,360,464,448,677,22,0,213
IMG_3326.MOV,486,361,464,448,677,22,0,213
IMG_3326.MOV,487,361,464,448,677,22,0,213
IMG_3326.MOV,488,362,464,448,677,22,0,213
IMG_3326.MOV,489,362,462,449,678,22,0,216
IMG_3326.MOV,490,362,460,450,678,22,0,218
IMG_3326.MOV,491,362,460,450,679,22,0,219
IMG_3326.MOV,492,363,461,450,677,22,0,216
IMG_3326.MOV,493,364,461,450,677,22,0,216
IMG_3326.MOV,494,364,461,451,677,22,0,216
IMG_3326.MOV,495,366,463,451,677,22,0,214
IMG_3326.MOV,496,368,463,453,677,22,0,214
IMG_3326.MOV,497,369,461,454,677,22,0,216
IMG_3326.MOV,498,370,462,455,678,22,0,216
IMG_3326.MOV,499,372,463,457,679,22,0,216
IMG_3326.MOV,500,373,461,458,679,22,0,218
IMG_3326.MOV,501,373,461,459,679,22,0,218
IMG_3326.MOV,502,375,465,459,677,22,0,212
IMG_3326.MOV,503,377,467,461,677,22,0,210
IMG_3326.MOV,504,379,467,463,679,22,0,212
IMG_3326.MOV,505,379,468,464,679,22,0,211
IMG_3326.MOV,506,379,466,465,680,22,0,214
IMG_3326.MOV,507,380,470,465,680,22,0,210
IMG_3326.MOV,508,380,472,466,681,22,0,209
IMG_3326.MOV,509,384,479,468,684,22,0,205
IMG_3326.MOV,510,387,482,470,687,22,0,205
IMG_3326.MOV,511,388,481,472,688,22,0,207
IMG_3326.MOV,512,386,473,473,688,22,0,215
IMG_3326.MOV,513,386,470,474,686,22,0,216
IMG_3326.MOV,514,388,477,474,688,22,0,211
IMG_3326.MOV,515,390,480,474,688,22,0,208
IMG_3326.MOV,516,391,484,473,685,22,0,201
IMG_3326.MOV,517,389,475,475,686,22,0,211
IMG_3326.MOV,518,389,472,477,686,22,0,214
IMG_3326.MOV,519,389,472,477,686,22,0,214
IMG_3326.MOV,520,389,472,478,688,22,0,216
IMG_3326.MOV,521,388,471,480,690,22,0,219
IMG_3326.MOV,522,389,471,482,691,22,0,220
IMG_3326.MOV,523,388,469,482,691,22,0,222
IMG_3326.MOV,524,388,468,483,690,22,0,222
IMG_3326.MOV,525,401,480,490,689,22,0,209
IMG_3326.MOV,526,406,483,492,689,22,0,206
IMG_3326.MOV,527,406,474,496,689,22,0,215
IMG_3326.MOV,528,407,469,498,688,22,0,219
IMG_3326.MOV,529,409,469,500,688,22,0,219
IMG_3326.MOV,530,410,471,501,688,22,0,217
IMG_3326.MOV,531,412,481,500,689,22,0,208
IMG_3326.MOV,532,413,477,504,691,22,0,214
IMG_3326.MOV,533,413,475,504,692,22,0,217
IMG_3326.MOV,534,413,473,505,692,22,0,219
IMG_3326.MOV,535,414,473,505,691,22,0,218
IMG_3326.MOV,536,414,473,506,691,22,0,218
IMG_3326.MOV,537,416,472,506,687,22,0,215
IMG_3326.MOV,538,416,471,506,687,22,0,216
IMG_3326.MOV,539,418,471,509,689,22,0,218
IMG_3326.MOV,540,418,469,509,689,22,0,220
IMG_3326.MOV,541,419,467,511,691,22,0,224
IMG_3326.MOV,542,420,467,512,693,22,0,226
IMG_3326.MOV,543,420,467,512,694,22,0,227
IMG_3326.MOV,544,421,468,512,695,22,0,227
IMG_3326.MOV,545,422,469,512,697,22,0,228
IMG_3326.MOV,546,424,470,514,699,22,0,229
IMG_3326.MOV,547,427,470,517,700,22,0,230
IMG_3326.MOV,548,429,470,520,702,22,0,232
IMG_3326.MOV,549,430,470,521,702,22,0,232
IMG_3326.MOV,550,432,470,524,704,22,0,234
IMG_3326.MOV,551,433,470,526,706,22,0,236
IMG_3326.MOV,552,434,470,529,707,22,0,237
IMG_3326.MOV,553,436,471,531,708,22,0,237
IMG_3326.MOV,554,436,471,531,707,22,0,236
IMG_3326.MOV,555,437,472,531,707,22,0,235
IMG_3326.MOV,556,440,474,533,706,22,0,232
IMG_3326.MOV,557,442,476,534,705,22,0,229
IMG_3326.MOV,558,445,478,535,705,22,0,227
IMG_3326.MOV,559,446,480,536,705,22,0,225
IMG_3326.MOV,560,448,479,537,704,22,0,225
IMG_3326.MOV,561,452,483,538,702,22,0,219
IMG_3326.MOV,562,454,486,539,700,22,0,214
IMG_3326.MOV,563,458,489,542,698,22,0,209
IMG_3326.MOV,564,460,489,543,698,22,0,209
IMG_3326.MOV,565,461,489,546,701,22,0,212
IMG_3326.MOV,566,463,487,549,702,22,0,215
IMG_3326.MOV,567,464,483,552,704,22,0,221
IMG_3326.MOV,568,463,481,554,706,22,0,225
IMG_3326.MOV,569,477,480,569,703,22,0,223
IMG_3326.MOV,570,483,482,575,701,22,0,219
IMG_3326.MOV,571,481,480,578,706,22,0,226
IMG_3326.MOV,572,481,477,582,710,22,0,233
IMG_3326.MOV,573,479,476,584,714,22,0,238
IMG_3326.MOV,574,480,475,586,715,22,0,240
IMG_3326.MOV,575,481,476,588,717,22,0,241
IMG_3326.MOV,576,482,477,590,718,22,0,241
IMG_3326.MOV,577,484,477,592,720,22,0,243
IMG_3326.MOV,578,485,477,595,722,22,0,245
IMG_3326.MOV,579,487,479,597,723,22,0,244
IMG_3326.MOV,580,487,479,596,720,22,0,241
IMG_3326.MOV,581,489,481,595,717,22,0,236
IMG_3326.MOV,582,489,481,596,715,22,0,234
IMG_3326.MOV,583,490,481,596,715,22,0,234
IMG_3326.MOV,584,490,480,597,715,22,0,235
IMG_3326.MOV,585,491,479,599,718,22,0,239
IMG_3326.MOV,586,490,477,601,720,22,0,243
IMG_3326.MOV,587,490,477,600,719,22,0,242
IMG_3326.MOV,588,492,479,601,719,22,0,240
IMG_3326.MOV,589,491,479,601,719,22,0,240
IMG_3326.MOV,590,491,481,600,719,22,0,238
IMG_3326.MOV,591,493,483,600,718,22,0,235
IMG_3326.MOV,592,492,482,602,720,22,0,238
IMG_3326.MOV,593,493,482,602,718,22,0,236
IMG_3326.MOV,594,493,480,603,717,22,0,237
IMG_3326.MOV,595,493,477,605,715,22,0,238
IMG_3326.MOV,596,495,478,604,712,22,0,234
IMG_3326.MOV,597,495,477,605,712,22,0,235
IMG_3326.MOV,598,496,476,607,712,22,0,236
IMG_3326.MOV,599,498,474,610,714,22,0,240
IMG_3326.MOV,600,499,473,611,712,22,0,239
IMG_3326.MOV,601,499,471,613,716,22,0,245
IMG_3326.MOV,602,499,469,614,717,22,0,248
IMG_3326.MOV,603,501,468,616,718,22,0,250
IMG_3326.MOV,604,501,468,616,718,22,0,250
IMG_3326.MOV,605,503,469,617,719,22,0,250
IMG_3326.MOV,606,504,471,618,719,22,0,248
IMG_3326.MOV,607,505,471,620,721,22,0,250
IMG_3326.MOV,608,506,471,620,721,22,0,250
IMG_3326.MOV,609,509,469,623,721,22,0,252
IMG_3326.MOV,610,512,471,624,719,22,0,248
IMG_3326.MOV,611,514,471,624,717,22,0,246
IMG_3326.MOV,612,521,481,624,711,22,0,230
IMG_3326.MOV,613,523,482,624,710,22,0,228
IMG_3326.MOV,614,522,480,624,709,22,0,229
IMG_3326.MOV,615,519,474,625,712,22,0,238
IMG_3326.MOV,616,518,471,627,715,22,0,244
IMG_3326.MOV,617,519,470,630,718,22,0,248
IMG_3326.MOV,618,522,470,632,718,22,0,248
IMG_3326.MOV,619,524,471,633,716,22,0,245
IMG_3326.MOV,620,524,470,633,713,22,0,243
IMG_3326.MOV,621,539,479,645,716,22,0,237
IMG_3326.MOV,622,547,486,652,718,22,0,232
IMG_3326.MOV,623,550,489,655,719,22,0,230
IMG_3326.MOV,624,552,486,660,721,22,0,235
IMG_3326.MOV,625,555,483,665,721,22,0,238
IMG_3326.MOV,626,554,478,668,722,22,0,244
IMG_3326.MOV,627,557,476,674,726,22,0,250
IMG_3326.MOV,628,559,478,676,725,22,0,247
IMG_3326.MOV,629,552,474,673,724,22,0,250
IMG_3326.MOV,630,558,496,675,731,22,0,235
IMG_3326.MOV,631,561,506,677,736,22,0,230
IMG_3326.MOV,632,559,510,677,742,22,0,232
IMG_3326.MOV,633,564,508,684,745,22,0,237
IMG_3326.MOV,634,568,509,687,745,22,0,236
IMG_3326.MOV,635,571,509,690,743,22,0,234
IMG_3326.MOV,636,571,510,691,745,22,0,235
IMG_3326.MOV,637,566,512,689,751,22,0,239
IMG_3326.MOV,638,569,512,692,751,22,0,239
IMG_3326.MOV,639,572,510,694,751,22,0,241
IMG_3326.MOV,640,575,510,696,751,22,0,241
IMG_3326.MOV,641,573,508,694,752,22,0,244
IMG_3326.MOV,642,573,507,694,751,22,0,244
IMG_3326.MOV,643,573,503,694,752,22,0,249
IMG_3326.MOV,644,580,503,700,751,22,0,248
IMG_3326.MOV,645,584,506,701,752,22,0,246
IMG_3326.MOV,646,588,507,702,751,22,0,244
IMG_3326.MOV,647,588,506,702,751,22,0,245
IMG_3326.MOV,648,592,510,699,744,22,0,234
IMG_3326.MOV,296,546,447,605,650,24,0,203
IMG_3326.MOV,297,542,425,605,645,24,0,220
IMG_3326.MOV,298,545,436,605,646,24,0,210
IMG_3326.MOV,299,540,418,605,646,24,0,228
IMG_3326.MOV,300,538,412,606,646,24,0,234
IMG_3326.MOV,301,537,409,606,646,24,0,237
IMG_3326.MOV,302,536,407,606,646,24,0,239
IMG_3326.MOV,303,536,404,606,646,24,0,242
IMG_3326.MOV,304,536,402,607,646,24,0,244
IMG_3326.MOV,305,539,402,610,645,24,0,243
IMG_3326.MOV,306,540,403,612,645,24,0,242
IMG_3326.MOV,307,541,402,615,645,24,0,243
IMG_3326.MOV,308,542,401,617,647,24,0,246
IMG_3326.MOV,309,543,402,619,647,24,0,245
IMG_3326.MOV,310,543,401,620,649,24,0,248
IMG_3326.MOV,311,551,401,630,651,24,0,250
IMG_3326.MOV,312,556,403,636,650,24,0,247
IMG_3326.MOV,313,559,404,639,648,24,0,244
IMG_3326.MOV,314,559,404,641,647,24,0,243
IMG_3326.MOV,315,559,404,642,647,24,0,243
IMG_3326.MOV,316,562,406,646,648,24,0,242
IMG_3326.MOV,317,563,407,649,650,24,0,243
IMG_3326.MOV,318,564,407,651,650,24,0,243
IMG_3326.MOV,319,564,409,652,650,24,0,241
IMG_3326.MOV,320,565,408,655,652,24,0,244
IMG_3326.MOV,321,566,407,657,652,24,0,245
IMG_3326.MOV,322,566,406,658,654,24,0,248
IMG_3326.MOV,323,566,407,659,655,24,0,248
IMG_3326.MOV,324,567,410,658,652,24,0,242
IMG_3326.MOV,325,567,411,657,651,24,0,240
IMG_3326.MOV,326,568,412,658,651,24,0,239
IMG_3326.MOV,327,569,410,660,654,24,0,244
IMG_3326.MOV,328,569,408,661,655,24,0,247
IMG_3326.MOV,329,571,408,663,656,24,0,248
IMG_3326.MOV,330,573,407,666,656,24,0,249
IMG_3326.MOV,331,575,406,668,656,24,0,250
IMG_3326.MOV,332,576,406,670,656,24,0,250
IMG_3326.MOV,333,578,405,671,656,24,0,251
IMG_3326.MOV,334,579,405,672,656,24,0,251
IMG_3326.MOV,335,580,405,673,656,24,0,251
IMG_3326.MOV,336,581,405,674,658,24,0,253
IMG_3326.MOV,337,583,404,675,659,24,0,255
IMG_3326.MOV,338,585,405,676,660,24,0,255
IMG_3326.MOV,339,586,405,677,660,24,0,255
IMG_3326.MOV,340,587,406,677,659,24,0,253
IMG_3326.MOV,341,589,414,680,668,24,0,254
IMG_3326.MOV,342,592,416,684,672,24,0,256
IMG_3326.MOV,343,595,417,687,674,24,0,257
IMG_3326.MOV,344,598,417,690,674,24,0,257
IMG_3326.MOV,345,600,418,693,674,24,0,256
IMG_3326.MOV,346,602,418,697,676,24,0,258
IMG_3326.MOV,347,604,419,700,677,24,0,258
IMG_3326.MOV,348,605,420,702,677,24,0,257
IMG_3326.MOV,349,606,421,704,676,24,0,255
IMG_3326.MOV,350,605,422,704,677,24,0,255
IMG_3326.MOV,351,604,422,704,679,24,0,257
IMG_3326.MOV,352,603,423,704,680,24,0,257
IMG_3326.MOV,353,604,423,704,681,24,0,258
IMG_3326.MOV,354,603,421,705,683,24,0,262
IMG_3326.MOV,355,603,420,707,685,24,0,265
IMG_3326.MOV,356,613,417,721,688,24,0,271
IMG_3326.MOV,357,617,417,728,690,24,0,273
IMG_3326.MOV,358,619,417,731,690,24,0,273
IMG_3326.MOV,359,618,416,731,691,24,0,275
IMG_3326.MOV,360,619,417,732,690,24,0,273
IMG_3326.MOV,361,620,419,732,688,24,0,269
IMG_3326.MOV,362,622,421,732,683,24,0,262
IMG_3326.MOV,363,623,421,732,682,24,0,261
IMG_3326.MOV,364,621,419,733,686,24,0,267
IMG_3326.MOV,365,621,418,732,687,24,0,269
IMG_3326.MOV,366,622,418,732,686,24,0,268
IMG_3326.MOV,367,622,418,731,685,24,0,267
IMG_3326.MOV,368,623,417,731,684,24,0,267
IMG_3326.MOV,369,624,416,731,684,24,0,268
IMG_3326.MOV,370,626,417,731,684,24,0,267
IMG_3326.MOV,371,627,415,733,687,24,0,272
IMG_3326.MOV,372,629,416,734,687,24,0,271
IMG_3326.MOV,373,631,418,735,685,24,0,267
IMG_3326.MOV,374,632,418,737,688,24,0,270
IMG_3326.MOV,375,635,418,740,689,24,0,271
IMG_3326.MOV,376,637,420,741,689,24,0,269
IMG_3326.MOV,377,639,422,743,692,24,0,270
IMG_3326.MOV,378,642,424,747,695,24,0,271
IMG_3326.MOV,379,643,425,749,696,24,0,271
IMG_3326.MOV,380,644,428,750,700,24,0,272
IMG_3326.MOV,381,645,430,751,701,24,0,271
IMG_3326.MOV,382,646,432,752,702,24,0,270
IMG_3326.MOV,383,647,433,755,702,24,0,269
IMG_3326.MOV,384,649,432,757,703,24,0,271
IMG_3326.MOV,385,650,433,758,705,24,0,272
IMG_3326.MOV,386,651,432,759,706,24,0,274
IMG_3326.MOV,387,651,433,759,707,24,0,274
IMG_3326.MOV,388,652,433,760,708,24,0,275
IMG_3326.MOV,389,654,433,762,710,24,0,277
IMG_3326.MOV,390,657,433,764,711,24,0,278
IMG_3326.MOV,391,660,433,765,711,24,0,278
IMG_3326.MOV,392,662,431,766,710,24,0,279
IMG_3326.MOV,393,664,430,767,710,24,0,280
IMG_3326.MOV,394,666,428,768,710,24,0,282
IMG_3326.MOV,395,668,427,769,709,24,0,282
IMG_3326.MOV,396,672,427,772,710,24,0,283
IMG_3326.MOV,397,675,427,774,709,24,0,282
IMG_3326.MOV,398,677,427,777,710,24,0,283
IMG_3326.MOV,399,679,426,780,714,24,0,288
IMG_3326.MOV,400,681,426,781,713,24,0,287
IMG_3326.MOV,401,690,427,790,713,24,0,286
IMG_3326.MOV,402,694,429,794,712,24,0,283
IMG_3326.MOV,403,697,429,799,717,24,0,288
IMG_3326.MOV,404,700,431,803,716,24,0,285
IMG_3326.MOV,405,703,431,808,716,24,0,285
IMG_3326.MOV,406,706,432,812,715,24,0,283
IMG_3326.MOV,407,707,435,814,715,24,0,280
IMG_3326.MOV,408,707,438,816,718,24,0,280
IMG_3326.MOV,409,708,440,816,716,24,0,276
IMG_3326.MOV,410,708,441,817,719,24,0,278
IMG_3326.MOV,411,707,441,817,721,24,0,280
IMG_3326.MOV,412,708,443,817,720,24,0,277
IMG_3326.MOV,413,708,444,817,722,24,0,278
IMG_3326.MOV,414,712,444,821,722,24,0,278
IMG_3326.MOV,415,716,444,827,721,24,0,277
IMG_3326.MOV,416,718,444,831,722,24,0,278
IMG_3326.MOV,417,720,444,835,722,24,0,278
IMG_3326.MOV,418,721,443,838,725,24,0,282
IMG_3326.MOV,419,723,441,843,726,24,0,285
IMG_3326.MOV,420,723,441,844,727,24,0,286
IMG_3326.MOV,421,723,441,845,727,24,0,286
IMG_3326.MOV,422,722,441,844,728,24,0,287
IMG_3326.MOV,423,721,441,844,731,24,0,290
IMG_3326.MOV,424,722,441,844,731,24,0,290
IMG_3326.MOV,425,724,440,846,732,24,0,292
IMG_3326.MOV,426,726,440,847,732,24,0,292
IMG_3326.MOV,427,727,439,847,732,24,0,293
IMG_3326.MOV,428,729,439,847,733,24,0,294
IMG_3326.MOV,429,731,439,847,733,24,0,294
IMG_3326.MOV,430,734,438,850,735,24,0,297
IMG_3326.MOV,431,738,437,853,738,24,0,301
IMG_3326.MOV,432,741,437,856,739,24,0,302
IMG_3326.MOV,433,744,436,859,741,24,0,305
IMG_3326.MOV,434,746,437,861,742,24,0,305
IMG_3326.MOV,435,746,436,863,744,24,0,308
IMG_3326.MOV,436,756,438,873,745,24,0,307
IMG_3326.MOV,437,758,435,880,752,24,0,317
IMG_3326.MOV,438,763,439,883,750,24,0,311
IMG_3326.MOV,439,764,442,884,750,24,0,308
IMG_3326.MOV,440,767,444,888,751,24,0,307
IMG_3326.MOV,441,771,448,890,750,24,0,302
IMG_3326.MOV,442,773,448,894,753,24,0,305
IMG_3326.MOV,443,774,447,897,755,24,0,308
IMG_3326.MOV,444,775,447,898,757,24,0,310
IMG_3326.MOV,445,777,447,900,758,24,0,311
IMG_3326.MOV,446,782,448,904,758,24,0,310
IMG_3326.MOV,447,785,449,905,758,24,0,309
IMG_3326.MOV,448,787,447,907,756,24,0,309
IMG_3326.MOV,449,792,448,910,755,24,0,307
IMG_3326.MOV,450,795,448,912,755,24,0,307
IMG_3326.MOV,451,798,449,913,755,24,0,306
IMG_3326.MOV,452,800,450,913,756,24,0,306
IMG_3326.MOV,453,802,449,914,758,24,0,309
IMG_3326.MOV,454,804,447,915,758,24,0,311
IMG_3326.MOV,455,806,445,917,762,24,0,317
IMG_3326.MOV,456,808,441,921,766,24,0,325
IMG_3326.MOV,457,812,439,926,768,24,0,329
IMG_3326.MOV,458,816,439,929,769,24,0,330
IMG_3326.MOV,459,819,440,932,769,24,0,329
IMG_3326.MOV,460,822,442,934,768,24,0,326
IMG_3326.MOV,461,832,443,944,767,24,0,324
IMG_3326.MOV,462,838,444,952,768,24,0,324
IMG_3326.MOV,463,840,452,956,778,24,0,326
IMG_3326.MOV,464,843,457,960,778,24,0,321
IMG_3326.MOV,465,846,460,964,778,24,0,318
IMG_3326.MOV,466,851,463,969,778,24,0,315
IMG_3326.MOV,467,850,464,970,777,24,0,313
IMG_3326.MOV,468,851,465,972,778,24,0,313
IMG_3326.MOV,469,854,467,975,778,24,0,311
IMG_3326.MOV,470,854,469,977,779,24,0,310
IMG_3326.MOV,471,848,468,972,783,24,0,315
IMG_3326.MOV,472,846,467,971,789,24,0,322
IMG_3326.MOV,473,848,467,973,792,24,0,325
IMG_3326.MOV,474,852,468,977,792,24,0,324
IMG_3326.MOV,475,853,469,978,793,24,0,324
IMG_3326.MOV,476,855,469,979,794,24,0,325
IMG_3326.MOV,477,856,468,979,795,24,0,327
IMG_3326.MOV,478,861,469,983,793,24,0,324
IMG_3326.MOV,479,867,468,991,792,24,0,324
IMG_3326.MOV,480,875,467,1000,793,24,0,326
IMG_3326.MOV,481,878,466,1005,792,24,0,326
IMG_3326.MOV,482,880,466,1007,790,24,0,324
IMG_3326.MOV,483,881,466,1010,789,24,0,323
IMG_3326.MOV,484,881,463,1010,789,24,0,326
IMG_3326.MOV,485,883,463,1011,788,24,0,325
IMG_3326.MOV,486,885,463,1014,788,24,0,325
IMG_3326.MOV,487,885,464,1013,788,24,0,324
IMG_3326.MOV,488,887,462,1015,788,24,0,326
IMG_3326.MOV,489,889,464,1016,792,24,0,328
IMG_3326.MOV,490,890,464,1017,796,24,0,332
IMG_3326.MOV,491,898,459,1027,797,24,0,338
IMG_3326.MOV,492,902,460,1029,797,24,0,337
IMG_3326.MOV,493,904,461,1031,797,24,0,336
IMG_3326.MOV,494,907,462,1035,801,24,0,339
IMG_3326.MOV,495,910,466,1038,803,24,0,337
IMG_3326.MOV,496,912,467,1041,806,24,0,339
IMG_3326.MOV,497,915,467,1046,808,24,0,341
IMG_3326.MOV,498,918,467,1051,810,24,0,343
IMG_3326.MOV,499,923,468,1058,812,24,0,344
IMG_3326.MOV,500,927,470,1062,813,24,0,343
IMG_3326.MOV,501,931,472,1066,813,24,0,341
IMG_3326.MOV,502,932,473,1069,816,24,0,343
IMG_3326.MOV,503,933,476,1070,819,24,0,343
IMG_3326.MOV,504,934,476,1072,821,24,0,345
IMG_3326.MOV,505,935,476,1075,823,24,0,347
IMG_3326.MOV,506,936,476,1076,824,24,0,348
IMG_3326.MOV,507,939,478,1077,824,24,0,346
IMG_3326.MOV,508,941,479,1079,824,24,0,345
IMG_3326.MOV,509,943,479,1081,826,24,0,347
IMG_3326.MOV,510,946,478,1083,826,24,0,348
IMG_3326.MOV,511,950,476,1086,826,24,0,350
IMG_3326.MOV,512,953,475,1088,825,24,0,350
IMG_3326.MOV,513,957,474,1089,824,24,0,350
IMG_3326.MOV,514,961,473,1092,825,24,0,352
IMG_3326.MOV,515,971,474,1099,825,24,0,351
IMG_3326.MOV,516,976,475,1102,824,24,0,349
IMG_3326.MOV,517,979,475,1103,824,24,0,349
IMG_3326.MOV,518,982,476,1105,824,24,0,348
IMG_3326.MOV,519,984,474,1107,829,24,0,355
IMG_3326.MOV,520,987,475,1112,834,24,0,359
IMG_3326.MOV,521,990,477,1116,837,24,0,360
IMG_3326.MOV,522,991,479,1119,843,24,0,364
IMG_3326.MOV,523,995,480,1125,850,24,0,370
IMG_3326.MOV,524,996,481,1129,852,24,0,371
IMG_3326.MOV,525,1000,481,1135,854,24,0,373
IMG_3326.MOV,526,1010,482,1143,849,24,0,367
IMG_3326.MOV,527,1016,485,1149,845,24,0,360
IMG_3326.MOV,528,1023,490,1157,844,24,0,354
IMG_3326.MOV,529,1027,491,1164,843,24,0,352
IMG_3326.MOV,530,1029,494,1168,843,24,0,349
IMG_3326.MOV,531,1029,495,1170,843,24,0,348
IMG_3326.MOV,532,1028,496,1173,845,24,0,349
IMG_3326.MOV,533,1026,500,1171,846,24,0,346
IMG_3326.MOV,534,1039,505,1187,847,24,0,342
IMG_3326.MOV,535,1045,507,1196,848,24,0,341
IMG_3326.MOV,536,1046,507,1202,849,24,0,342
IMG_3326.MOV,537,1046,505,1206,851,24,0,346
IMG_3326.MOV,538,1044,504,1208,854,24,0,350
IMG_3326.MOV,539,1047,504,1213,855,24,0,351
IMG_3326.MOV,540,1048,503,1216,855,24,0,352
IMG_3326.MOV,541,1048,503,1215,854,24,0,351
IMG_3326.MOV,542,1052,496,1226,859,24,0,363
IMG_3326.MOV,543,1054,494,1230,861,24,0,367
IMG_3326.MOV,544,1053,493,1230,863,24,0,370
IMG_3326.MOV,545,1053,491,1229,864,24,0,373
IMG_3326.MOV,546,1055,491,1230,865,24,0,374
IMG_3326.MOV,547,1055,488,1229,869,24,0,381
IMG_3326.MOV,548,1058,488,1229,869,24,0,381
IMG_3326.MOV,549,1062,490,1228,868,24,0,378
IMG_3326.MOV,550,1064,489,1229,869,24,0,380
IMG_3326.MOV,551,1068,487,1229,869,24,0,382
IMG_3326.MOV,552,1074,491,1231,865,24,0,374
IMG_3326.MOV,553,1077,489,1233,868,24,0,379
IMG_3326.MOV,554,1080,489,1235,871,24,0,382
IMG_3326.MOV,555,1082,494,1239,885,24,0,391
IMG_3326.MOV,556,1085,499,1241,892,24,0,393
IMG_3326.MOV,557,1088,502,1244,893,24,0,391
IMG_3326.MOV,558,1094,505,1249,894,24,0,389
IMG_3326.MOV,559,1106,506,1261,896,24,0,390
IMG_3326.MOV,560,1113,508,1268,898,24,0,390
IMG_3326.MOV,561,1115,507,1273,903,24,0,396
IMG_3326.MOV,562,1117,510,1275,904,24,0,394
IMG_3326.MOV,563,1117,513,1277,908,24,0,395
IMG_3326.MOV,564,1117,512,1280,913,24,0,401
IMG_3326.MOV,565,1118,514,1280,910,24,0,396
IMG_3326.MOV,566,1120,513,1284,913,24,0,400
IMG_3326.MOV,567,1123,513,1288,913,24,0,400
IMG_3326.MOV,568,1126,513,1292,916,24,0,403
IMG_3326.MOV,569,1128,512,1295,918,24,0,406
IMG_3326.MOV,570,1131,511,1297,918,24,0,407
IMG_3326.MOV,571,1135,509,1301,920,24,0,411
IMG_3326.MOV,572,1140,509,1304,919,24,0,410
IMG_3326.MOV,573,1145,509,1308,919,24,0,410
IMG_3326.MOV,574,1150,511,1310,916,24,0,405
IMG_3326.MOV,575,1155,510,1314,918,24,0,408
IMG_3326.MOV,576,1159,508,1317,919,24,0,411
IMG_3326.MOV,577,1165,508,1321,919,24,0,411
IMG_3326.MOV,578,1169,510,1322,918,24,0,408
IMG_3326.MOV,579,1172,512,1324,923,24,0,411
IMG_3326.MOV,580,1182,512,1333,927,24,0,415
IMG_3326.MOV,581,1188,510,1340,933,24,0,423
IMG_3326.MOV,582,1192,508,1346,937,24,0,429
IMG_3326.MOV,583,1196,509,1350,940,24,0,431
IMG_3326.MOV,584,1202,511,1355,939,24,0,428
IMG_3326.MOV,585,1204,512,1362,955,24,0,443
IMG_3326.MOV,586,1208,514,1368,958,24,0,444
IMG_3326.MOV,587,1216,518,1375,958,24,0,440
IMG_3326.MOV,588,1221,521,1383,960,24,0,439
IMG_3326.MOV,589,1226,522,1390,964,24,0,442
IMG_3326.MOV,590,1229,523,1397,967,24,0,444
IMG_3326.MOV,591,1232,523,1403,970,24,0,447
IMG_3326.MOV,592,1235,522,1409,977,24,0,455
IMG_3326.MOV,593,1244,527,1427,997,24,0,470
IMG_3326.MOV,594,1249,532,1435,1001,24,0,469
IMG_3326.MOV,595,1252,535,1442,1005,24,0,470
IMG_3326.MOV,596,1255,537,1448,1008,24,0,471
IMG_3326.MOV,597,1255,538,1452,1013,24,0,475
IMG_3326.MOV,598,1255,537,1457,1022,24,0,485
IMG_3326.MOV,599,1259,540,1462,1020,24,0,480
IMG_3326.MOV,600,1264,543,1466,1015,24,0,472
IMG_3326.MOV,601,1266,541,1470,1012,24,0,471
IMG_3326.MOV,602,1269,541,1475,1011,24,0,470
IMG_3326.MOV,603,1271,540,1478,1011,24,0,471
IMG_3326.MOV,604,1277,538,1483,1009,24,0,471
IMG_3326.MOV,605,1282,540,1485,1004,24,0,464
IMG_3326.MOV,606,1281,539,1486,1007,24,0,468
IMG_3326.MOV,607,1283,539,1486,1007,24,0,468
IMG_3326.MOV,608,1282,538,1487,1016,24,0,478
IMG_3326.MOV,609,1282,536,1486,1019,24,0,483
IMG_3326.MOV,610,1288,538,1486,1014,24,0,476
IMG_3326.MOV,611,1290,539,1485,1012,24,0,473
IMG_3326.MOV,612,1296,539,1485,1006,24,0,467
IMG_3326.MOV,613,1299,542,1485,1006,24,0,464
IMG_3326.MOV,614,1303,543,1484,1003,24,0,460
IMG_3326.MOV,615,1309,542,1492,1010,24,0,468
IMG_3326.MOV,616,1318,541,1499,1009,24,0,468
IMG_3326.MOV,617,1321,539,1505,1017,24,0,478
IMG_3326.MOV,618,1326,537,1514,1028,24,0,491
IMG_3326.MOV,619,1332,537,1520,1030,24,0,493
IMG_3326.MOV,620,1337,541,1522,1025,24,0,484
IMG_3326.MOV,621,1346,547,1533,1030,24,0,483
IMG_3326.MOV,622,1349,547,1542,1039,24,0,492
IMG_3326.MOV,623,1349,543,1549,1045,24,0,502
IMG_3326.MOV,624,1346,543,1553,1054,24,0,511
IMG_3326.MOV,625,1343,545,1554,1062,24,0,517
IMG_3326.MOV,626,1346,550,1560,1067,24,0,517
IMG_3326.MOV,627,1347,555,1563,1069,24,0,514
IMG_3326.MOV,628,1350,559,1567,1068,24,0,509
IMG_3326.MOV,629,1354,560,1573,1071,24,0,511
IMG_3326.MOV,630,1355,558,1577,1074,24,0,516
IMG_3326.MOV,631,1357,557,1580,1076,24,0,519
IMG_3326.MOV,632,1355,556,1581,1077,24,0,521
IMG_3326.MOV,633,1367,555,1593,1078,24,0,523
IMG_3326.MOV,634,1374,556,1598,1077,24,0,521
IMG_3326.MOV,635,1378,554,1601,1076,24,0,522
IMG_3326.MOV,636,1384,553,1606,1076,24,0,523
IMG_3326.MOV,637,1394,554,1613,1076,24,0,522
IMG_3326.MOV,638,1404,553,1619,1075,24,0,522
IMG_3326.MOV,639,1413,553,1623,1071,24,0,518
IMG_3326.MOV,640,1421,551,1627,1071,24,0,520
IMG_3326.MOV,641,1431,553,1631,1070,24,0,517
IMG_3326.MOV,642,1437,554,1633,1071,24,0,517
IMG_3326.MOV,643,1442,552,1635,1074,24,0,522
IMG_3326.MOV,644,1452,556,1642,1078,24,0,522
IMG_3326.MOV,645,1464,558,1650,1078,24,0,520
IMG_3326.MOV,646,1472,560,1655,1077,24,0,517
IMG_3326.MOV,647,1482,572,1658,1072,24,0,500
IMG_3326.MOV,648,1488,576,1660,1069,24,0,493
IMG_3326.MOV,304,0,420,35,547,25,0,127
IMG_3326.MOV,305,0,415,36,546,25,0,131
IMG_3326.MOV,307,0,392,41,545,25,0,153
IMG_3326.MOV,308,0,400,40,545,25,0,145
IMG_3326.MOV,309,1,401,41,546,25,0,145
IMG_3326.MOV,310,1,398,43,546,25,1,148
IMG_3326.MOV,311,0,381,42,536,25,0,155
IMG_3326.MOV,312,0,380,42,532,25,0,152
IMG_3326.MOV,313,0,378,43,532,25,0,154
IMG_3326.MOV,314,1,379,45,533,25,0,154
IMG_3326.MOV,315,2,380,45,532,25,0,152
IMG_3326.MOV,316,2,389,46,542,25,0,153
IMG_3326.MOV,317,3,393,48,547,25,0,154
IMG_3326.MOV,318,3,394,49,550,25,0,156
IMG_3326.MOV,319,3,394,50,550,25,0,156
IMG_3326.MOV,320,3,393,52,551,25,0,158
IMG_3326.MOV,321,3,391,53,552,25,0,161
IMG_3326.MOV,322,3,390,54,551,25,0,161
IMG_3326.MOV,323,3,389,55,552,25,0,163
IMG_3326.MOV,324,3,388,57,555,25,0,167
IMG_3326.MOV,325,2,389,57,556,25,0,167
IMG_3326.MOV,326,3,388,58,557,25,0,169
IMG_3326.MOV,327,2,388,59,557,25,0,169
IMG_3326.MOV,328,3,389,60,556,25,0,167
IMG_3326.MOV,329,8,389,67,557,25,0,168
IMG_3326.MOV,330,11,389,70,557,25,0,168
IMG_3326.MOV,331,13,390,72,555,25,0,165
IMG_3326.MOV,332,15,391,75,555,25,0,164
IMG_3326.MOV,333,16,391,76,553,25,0,162
IMG_3326.MOV,334,17,390,78,553,25,0,163
IMG_3326.MOV,335,17,390,78,553,25,0,163
IMG_3326.MOV,336,18,391,79,552,25,0,161
IMG_3326.MOV,337,18,392,80,550,25,0,158
IMG_3326.MOV,338,19,392,81,550,25,0,158
IMG_3326.MOV,339,20,392,84,550,25,0,158
IMG_3326.MOV,340,21,391,86,551,25,0,160
IMG_3326.MOV,341,22,391,87,551,25,0,160
IMG_3326.MOV,342,23,389,89,552,25,0,163
IMG_3326.MOV,343,25,390,90,552,25,0,162
IMG_3326.MOV,344,27,390,92,552,25,0,162
IMG_3326.MOV,345,29,389,94,552,25,0,163
IMG_3326.MOV,346,31,389,96,551,25,0,162
IMG_3326.MOV,347,33,389,97,551,25,0,162
IMG_3326.MOV,348,34,389,99,551,25,0,162
IMG_3326.MOV,349,35,389,99,550,25,0,161
IMG_3326.MOV,350,35,389,100,552,25,0,163
IMG_3326.MOV,351,36,391,100,552,25,0,161
IMG_3326.MOV,352,44,393,107,552,25,0,159
IMG_3326.MOV,353,46,392,111,553,25,0,161
IMG_3326.MOV,354,48,391,114,553,25,0,162
IMG_3326.MOV,355,49,391,115,553,25,0,162
IMG_3326.MOV,356,51,389,118,553,25,0,164
IMG_3326.MOV,357,52,389,119,553,25,0,164
IMG_3326.MOV,358,53,389,120,552,25,0,163
IMG_3326.MOV,359,54,388,120,552,25,0,164
IMG_3326.MOV,360,55,389,121,552,25,0,163
IMG_3326.MOV,361,56,390,122,552,25,0,162
IMG_3326.MOV,362,57,390,124,552,25,0,162
IMG_3326.MOV,363,58,390,125,552,25,0,162
IMG_3326.MOV,364,59,390,127,552,25,0,162
IMG_3326.MOV,365,60,390,128,552,25,0,162
IMG_3326.MOV,366,60,390,129,552,25,0,162
IMG_3326.MOV,367,62,390,131,551,25,0,161
IMG_3326.MOV,368,64,391,132,549,25,0,158
IMG_3326.MOV,369,66,391,134,549,25,0,158
IMG_3326.MOV,370,67,392,136,551,25,0,159
IMG_3326.MOV,371,67,392,138,552,25,0,160
IMG_3326.MOV,372,68,392,139,552,25,0,160
IMG_3326.MOV,373,68,392,139,553,25,0,161
IMG_3326.MOV,374,67,391,139,555,25,0,164
IMG_3326.MOV,375,68,389,140,556,25,0,167
IMG_3326.MOV,376,76,390,148,556,25,0,166
IMG_3326.MOV,377,80,392,152,557,25,0,165
IMG_3326.MOV,378,83,394,153,555,25,0,161
IMG_3326.MOV,379,84,397,153,555,25,0,158
IMG_3326.MOV,380,85,398,153,554,25,0,156
IMG_3326.MOV,381,86,399,153,555,25,0,156
IMG_3326.MOV,382,87,398,153,554,25,0,156
IMG_3326.MOV,383,88,397,154,552,25,0,155
IMG_3326.MOV,384,88,396,155,551,25,0,155
IMG_3326.MOV,385,89,394,155,552,25,0,158
IMG_3326.MOV,386,89,392,155,552,25,0,160
IMG_3326.MOV,387,88,391,154,553,25,0,162
IMG_3326.MOV,388,89,391,154,553,25,0,162
IMG_3326.MOV,389,90,390,155,555,25,0,165
IMG_3326.MOV,390,90,389,155,556,25,0,167
IMG_3326.MOV,391,92,389,157,557,25,0,168
IMG_3326.MOV,392,94,391,157,555,25,0,164
IMG_3326.MOV,393,96,391,160,555,25,0,164
IMG_3326.MOV,394,97,389,162,557,25,0,168
IMG_3326.MOV,395,98,388,164,557,25,0,169
IMG_3326.MOV,396,98,385,165,559,25,0,174
IMG_3326.MOV,397,99,384,166,560,25,0,176
IMG_3326.MOV,398,100,371,169,553,25,0,182
IMG_3326.MOV,399,101,380,168,556,25,0,176
IMG_3326.MOV,400,101,383,169,559,25,0,176
IMG_3326.MOV,401,102,382,170,562,25,0,180
IMG_3326.MOV,402,102,382,172,565,25,0,183
IMG_3326.MOV,403,103,383,172,564,25,0,181
IMG_3326.MOV,404,103,385,172,564,25,0,179
IMG_3326.MOV,405,104,386,172,563,25,0,177
IMG_3326.MOV,406,105,386,172,563,25,0,177
IMG_3326.MOV,407,105,384,174,564,25,0,180
IMG_3326.MOV,408,104,380,175,565,25,0,185
IMG_3326.MOV,409,105,381,175,564,25,0,183
IMG_3326.MOV,410,106,382,174,564,25,0,182
IMG_3326.MOV,411,117,392,180,560,25,0,168
IMG_3326.MOV,412,121,395,184,559,25,0,164
IMG_3326.MOV,413,124,398,186,561,25,0,163
IMG_3326.MOV,414,126,401,187,559,25,0,158
IMG_3326.MOV,415,127,400,189,560,25,0,160
IMG_3326.MOV,416,128,399,190,560,25,0,161
IMG_3326.MOV,417,129,396,194,561,25,0,165
IMG_3326.MOV,418,129,392,196,563,25,0,171
IMG_3326.MOV,419,129,390,197,563,25,0,173
IMG_3326.MOV,420,129,389,197,563,25,0,174
IMG_3326.MOV,421,128,389,197,563,25,0,174
IMG_3326.MOV,422,128,390,197,564,25,0,174
IMG_3326.MOV,423,130,394,197,563,25,0,169
IMG_3326.MOV,424,132,395,198,562,25,0,167
IMG_3326.MOV,425,133,395,199,563,25,0,168
IMG_3326.MOV,426,135,397,199,561,25,0,164
IMG_3326.MOV,427,135,396,201,561,25,0,165
IMG_3326.MOV,428,137,396,202,561,25,0,165
IMG_3326.MOV,429,138,396,203,561,25,0,165
IMG_3326.MOV,430,139,400,203,560,25,0,160
IMG_3326.MOV,431,141,404,203,560,25,0,156
IMG_3326.MOV,432,142,405,205,561,25,0,156
IMG_3326.MOV,433,142,403,207,563,25,0,160
IMG_3326.MOV,434,142,402,208,563,25,0,161
IMG_3326.MOV,435,142,401,210,564,25,0,163
IMG_3326.MOV,436,142,399,211,565,25,0,166
IMG_3326.MOV,437,142,400,212,566,25,0,166
IMG_3326.MOV,438,141,398,213,566,25,0,168
IMG_3326.MOV,439,141,396,215,567,25,0,171
IMG_3326.MOV,440,141,397,215,568,25,0,171
IMG_3326.MOV,441,142,397,215,566,25,0,169
IMG_3326.MOV,442,142,398,215,565,25,0,167
IMG_3326.MOV,443,142,399,215,565,25,0,166
IMG_3326.MOV,444,150,403,221,566,25,0,163
IMG_3326.MOV,445,152,403,224,567,25,0,164
IMG_3326.MOV,446,154,403,226,567,25,0,164
IMG_3326.MOV,447,153,400,227,568,25,0,168
IMG_3326.MOV,448,154,399,228,568,25,0,169
IMG_3326.MOV,449,155,397,230,568,25,0,171
IMG_3326.MOV,450,155,397,230,568,25,0,171
IMG_3326.MOV,451,155,398,230,567,25,0,169
IMG_3326.MOV,452,155,399,229,565,25,0,166
IMG_3326.MOV,453,156,400,229,566,25,0,166
IMG_3326.MOV,454,156,400,230,567,25,0,167
IMG_3326.MOV,455,156,400,230,569,25,0,169
IMG_3326.MOV,456,156,401,230,570,25,0,169
IMG_3326.MOV,457,157,401,230,570,25,0,169
IMG_3326.MOV,458,157,401,230,571,25,0,170
IMG_3326.MOV,459,158,402,229,570,25,0,168
IMG_3326.MOV,460,158,402,229,570,25,0,168
IMG_3326.MOV,461,159,402,229,570,25,0,168
IMG_3326.MOV,462,159,403,228,569,25,0,166
IMG_3326.MOV,463,159,403,227,567,25,0,164
IMG_3326.MOV,464,159,404,227,568,25,0,164
IMG_3326.MOV,465,158,404,227,569,25,0,165
IMG_3326.MOV,466,158,404,226,569,25,0,165
IMG_3326.MOV,467,158,404,226,570,25,0,166
IMG_3326.MOV,468,158,405,226,570,25,0,165
IMG_3326.MOV,469,158,405,225,570,25,0,165
IMG_3326.MOV,470,158,405,226,570,25,0,165
IMG_3326.MOV,471,158,405,225,570,25,0,165
IMG_3326.MOV,472,157,405,224,570,25,0,165
IMG_3326.MOV,473,157,404,224,571,25,0,167
IMG_3326.MOV,474,157,403,225,571,25,0,168
IMG_3326.MOV,475,157,403,225,571,25,0,168
IMG_3326.MOV,476,156,401,225,571,25,0,170
IMG_3326.MOV,477,156,399,225,570,25,0,171
IMG_3326.MOV,478,157,397,226,570,25,0,173
IMG_3326.MOV,479,146,393,217,570,25,0,177
IMG_3326.MOV,480,141,391,214,572,25,0,181
IMG_3326.MOV,481,139,390,213,572,25,0,182
IMG_3326.MOV,482,139,390,212,572,25,0,182
IMG_3326.MOV,483,138,390,211,569,25,0,179
IMG_3326.MOV,484,139,391,211,567,25,0,176
IMG_3326.MOV,485,139,393,210,565,25,0,172
IMG_3326.MOV,486,139,392,210,566,25,0,174
IMG_3326.MOV,487,138,391,211,567,25,0,176
IMG_3326.MOV,488,137,390,210,567,25,1,177
IMG_3326.MOV,494,162,371,243,576,25,0,205
IMG_3326.MOV,495,165,370,243,576,25,0,206
IMG_3326.MOV,496,166,370,243,576,25,0,206
IMG_3326.MOV,497,167,370,242,578,25,0,208
IMG_3326.MOV,498,168,368,241,581,25,0,213
IMG_3326.MOV,499,169,367,243,581,25,1,214
IMG_3326.MOV,500,167,367,240,582,25,0,215
IMG_3326.MOV,501,169,368,239,581,25,0,213
IMG_3326.MOV,502,169,368,238,580,25,0,212
IMG_3326.MOV,503,170,369,237,580,25,0,211
IMG_3326.MOV,504,171,370,237,580,25,0,210
IMG_3326.MOV,505,170,370,236,581,25,0,211
IMG_3326.MOV,506,170,371,235,579,25,0,208
IMG_3326.MOV,507,170,372,233,578,25,0,206
IMG_3326.MOV,508,170,373,233,577,25,0,204
IMG_3326.MOV,509,171,377,232,577,25,0,200
IMG_3326.MOV,510,171,378,232,577,25,0,199
IMG_3326.MOV,511,172,380,231,575,25,0,195
IMG_3326.MOV,512,172,381,231,575,25,0,194
IMG_3326.MOV,513,171,380,230,575,25,0,195
IMG_3326.MOV,514,170,382,228,575,25,0,193
IMG_3326.MOV,515,169,379,228,576,25,0,197
IMG_3326.MOV,516,168,378,228,577,25,0,199
IMG_3326.MOV,517,166,376,227,579,25,0,203
IMG_3326.MOV,518,165,375,227,580,25,0,205
IMG_3326.MOV,519,165,377,226,579,25,0,202
IMG_3326.MOV,520,166,381,226,577,25,0,196
IMG_3326.MOV,521,166,383,226,576,25,0,193
IMG_3326.MOV,522,165,379,226,577,25,0,198
IMG_3326.MOV,523,164,378,226,577,25,0,199
IMG_3326.MOV,524,163,377,226,577,25,0,200
IMG_3326.MOV,525,164,377,227,577,25,0,200
IMG_3326.MOV,526,165,378,228,577,25,0,199
IMG_3326.MOV,527,165,378,229,576,25,0,198
IMG_3326.MOV,528,165,376,230,576,25,0,200
IMG_3326.MOV,529,165,378,229,575,25,0,197
IMG_3326.MOV,530,166,381,230,574,25,0,193
IMG_3326.MOV,531,168,385,230,572,25,0,187
IMG_3326.MOV,532,169,387,231,572,25,0,185
IMG_3326.MOV,533,169,388,231,571,25,0,183
IMG_3326.MOV,534,169,389,230,570,25,0,181
IMG_3326.MOV,535,171,392,231,570,25,0,178
IMG_3326.MOV,536,171,393,232,570,25,0,177
IMG_3326.MOV,537,172,394,232,570,25,0,176
IMG_3326.MOV,538,173,395,233,570,25,0,175
IMG_3326.MOV,539,174,395,234,570,25,0,175
IMG_3326.MOV,540,174,395,234,570,25,0,175
IMG_3326.MOV,541,174,396,234,570,25,0,174
IMG_3326.MOV,542,174,395,234,571,25,0,176
IMG_3326.MOV,543,174,395,235,571,25,0,176
IMG_3326.MOV,544,175,394,235,572,25,0,178
IMG_3326.MOV,545,175,394,235,572,25,0,178
IMG_3326.MOV,546,175,394,236,572,25,0,178
IMG_3326.MOV,547,176,395,236,573,25,0,178
IMG_3326.MOV,548,176,395,235,572,25,0,177
IMG_3326.MOV,549,177,395,235,571,25,0,176
IMG_3326.MOV,550,177,395,235,571,25,0,176
IMG_3326.MOV,551,177,395,235,570,25,0,175
IMG_3326.MOV,552,177,394,235,570,25,0,176
IMG_3326.MOV,553,177,394,234,569,25,0,175
IMG_3326.MOV,554,177,394,235,568,25,0,174
IMG_3326.MOV,555,177,393,235,569,25,0,176
IMG_3326.MOV,556,177,392,235,569,25,0,177
IMG_3326.MOV,557,176,392,235,570,25,0,178
IMG_3326.MOV,558,177,392,235,570,25,0,178
IMG_3326.MOV,559,177,392,235,570,25,0,178
IMG_3326.MOV,560,177,392,236,570,25,0,178
IMG_3326.MOV,561,178,391,236,570,25,0,179
IMG_3326.MOV,562,178,390,237,570,25,0,180
IMG_3326.MOV,563,178,390,236,570,25,0,180
IMG_3326.MOV,564,178,389,236,570,25,0,181
IMG_3326.MOV,565,178,389,237,570,25,0,181
IMG_3326.MOV,566,178,388,237,571,25,0,183
IMG_3326.MOV,567,179,390,237,571,25,0,181
IMG_3326.MOV,568,179,391,237,571,25,0,180
IMG_3326.MOV,569,181,391,238,571,25,0,180
IMG_3326.MOV,570,181,391,238,572,25,0,181
IMG_3326.MOV,571,182,392,239,572,25,0,180
IMG_3326.MOV,572,182,391,239,573,25,0,182
IMG_3326.MOV,573,182,390,239,573,25,0,183
IMG_3326.MOV,574,182,390,239,573,25,0,183
IMG_3326.MOV,575,183,389,239,573,25,0,184
IMG_3326.MOV,576,183,390,239,574,25,0,184
IMG_3326.MOV,577,183,390,239,574,25,0,184
IMG_3326.MOV,578,184,390,239,574,25,0,184
IMG_3326.MOV,579,184,390,239,574,25,0,184
IMG_3326.MOV,580,185,390,239,574,25,0,184
IMG_3326.MOV,581,185,389,239,576,25,0,187
IMG_3326.MOV,582,185,389,239,575,25,0,186
IMG_3326.MOV,583,185,388,239,574,25,0,186
IMG_3326.MOV,584,185,388,238,574,25,0,186
IMG_3326.MOV,585,185,386,239,575,25,0,189
IMG_3326.MOV,586,185,387,239,575,25,0,188
IMG_3326.MOV,587,186,388,238,575,25,0,187
IMG_3326.MOV,588,186,388,238,575,25,0,187
IMG_3326.MOV,589,186,387,239,575,25,0,188
IMG_3326.MOV,590,186,387,239,574,25,0,187
IMG_3326.MOV,591,185,387,239,574,25,0,187
IMG_3326.MOV,592,186,386,239,574,25,0,188
IMG_3326.MOV,593,186,386,240,574,25,0,188
IMG_3326.MOV,594,186,387,239,574,25,0,187
IMG_3326.MOV,595,186,387,239,573,25,0,186
IMG_3326.MOV,596,185,387,240,573,25,0,186
IMG_3326.MOV,597,186,387,240,572,25,0,185
IMG_3326.MOV,598,186,386,240,572,25,0,186
IMG_3326.MOV,599,185,387,241,573,25,0,186
IMG_3326.MOV,600,185,387,241,573,25,0,186
IMG_3326.MOV,601,185,387,241,573,25,0,186
IMG_3326.MOV,602,185,386,242,574,25,0,188
IMG_3326.MOV,603,184,387,242,573,25,0,186
IMG_3326.MOV,604,185,387,242,571,25,0,184
IMG_3326.MOV,605,185,387,242,571,25,0,184
IMG_3326.MOV,606,184,387,242,571,25,0,184
IMG_3326.MOV,607,185,388,242,572,25,0,184
IMG_3326.MOV,608,185,388,242,573,25,0,185
IMG_3326.MOV,609,184,388,243,574,25,0,186
IMG_3326.MOV,610,184,388,242,575,25,0,187
IMG_3326.MOV,611,184,388,242,575,25,0,187
IMG_3326.MOV,612,184,388,242,576,25,0,188
IMG_3326.MOV,613,184,389,242,575,25,0,186
IMG_3326.MOV,614,184,389,242,575,25,0,186
IMG_3326.MOV,615,184,389,243,575,25,0,186
IMG_3326.MOV,616,184,389,243,573,25,0,184
IMG_3326.MOV,617,185,389,242,572,25,0,183
IMG_3326.MOV,618,185,389,243,572,25,0,183
IMG_3326.MOV,619,185,389,244,571,25,0,182
IMG_3326.MOV,620,194,394,250,569,25,0,175
IMG_3326.MOV,621,197,397,253,568,25,0,171
IMG_3326.MOV,622,199,398,255,567,25,0,169
IMG_3326.MOV,623,199,398,256,567,25,0,169
IMG_3326.MOV,624,198,396,257,568,25,0,172
IMG_3326.MOV,625,198,395,258,567,25,0,172
IMG_3326.MOV,626,197,394,258,568,25,0,174
IMG_3326.MOV,627,197,394,259,568,25,0,174
IMG_3326.MOV,628,197,393,260,568,25,0,175
IMG_3326.MOV,629,197,391,261,566,25,0,175
IMG_3326.MOV,630,197,391,263,566,25,0,175
IMG_3326.MOV,631,197,391,264,566,25,0,175
IMG_3326.MOV,632,197,391,265,565,25,0,174
IMG_3326.MOV,633,196,391,266,566,25,0,175
IMG_3326.MOV,634,196,391,267,566,25,0,175
IMG_3326.MOV,635,196,392,268,566,25,0,174
IMG_3326.MOV,636,196,393,268,566,25,0,173
IMG_3326.MOV,637,196,394,268,565,25,0,171
IMG_3326.MOV,638,196,395,269,565,25,0,170
IMG_3326.MOV,639,196,396,269,565,25,0,169
IMG_3326.MOV,640,196,395,269,565,25,0,170
IMG_3326.MOV,641,195,395,269,564,25,0,169
IMG_3326.MOV,642,195,395,269,563,25,0,168
IMG_3326.MOV,643,195,395,269,563,25,0,168
IMG_3326.MOV,644,195,395,269,563,25,0,168
IMG_3326.MOV,645,195,395,269,562,25,0,167
IMG_3326.MOV,646,195,394,270,562,25,0,168
IMG_3326.MOV,647,196,393,271,564,25,0,171
IMG_3326.MOV,648,196,393,272,564,25,0,171
IMG_3326.MOV,320,150,375,198,520,27,0,145
IMG_3326.MOV,321,149,374,197,522,27,0,148
IMG_3326.MOV,322,148,374,197,525,27,0,151
IMG_3326.MOV,323,147,374,196,525,27,0,151
IMG_3326.MOV,324,146,374,196,526,27,0,152
IMG_3326.MOV,325,146,373,196,528,27,0,155
IMG_3326.MOV,326,146,373,195,526,27,0,153
IMG_3326.MOV,327,146,371,196,526,27,0,155
IMG_3326.MOV,328,146,371,195,524,27,0,153
IMG_3326.MOV,329,145,371,193,520,27,0,149
IMG_3326.MOV,330,145,372,193,519,27,0,147
IMG_3326.MOV,331,145,372,192,518,27,0,146
IMG_3326.MOV,332,145,372,192,518,27,0,146
IMG_3326.MOV,333,144,373,191,518,27,0,145
IMG_3326.MOV,334,144,373,190,517,27,0,144
IMG_3326.MOV,335,144,373,189,515,27,0,142
IMG_3326.MOV,336,143,373,189,515,27,0,142
IMG_3326.MOV,337,142,371,188,516,27,0,145
IMG_3326.MOV,338,142,371,188,516,27,0,145
IMG_3326.MOV,339,142,369,188,518,27,0,149
IMG_3326.MOV,340,142,367,188,519,27,0,152
IMG_3326.MOV,341,142,365,190,521,27,0,156
IMG_3326.MOV,342,143,365,192,521,27,0,156
IMG_3326.MOV,343,143,364,192,522,27,0,158
IMG_3326.MOV,344,142,363,191,522,27,0,159
IMG_3326.MOV,345,142,363,190,522,27,0,159
IMG_3326.MOV,346,142,363,190,522,27,0,159
IMG_3326.MOV,347,143,363,191,522,27,0,159
IMG_3326.MOV,348,142,364,190,520,27,0,156
IMG_3326.MOV,349,143,365,191,522,27,0,157
IMG_3326.MOV,350,143,365,192,523,27,0,158
IMG_3326.MOV,351,143,365,191,521,27,0,156
IMG_3326.MOV,352,143,365,192,521,27,0,156
IMG_3326.MOV,353,145,365,196,524,27,0,159
IMG_3326.MOV,354,146,365,199,526,27,0,161
IMG_3326.MOV,355,147,367,201,530,27,0,163
IMG_3326.MOV,356,147,369,202,529,27,0,160
IMG_3326.MOV,357,148,371,202,526,27,0,155
IMG_3326.MOV,358,148,373,202,526,27,0,153
IMG_3326.MOV,359,148,374,202,526,27,0,152
IMG_3326.MOV,360,148,374,202,525,27,0,151
IMG_3326.MOV,361,147,373,202,525,27,0,152
IMG_3326.MOV,362,146,374,201,525,27,0,151
IMG_3326.MOV,363,145,374,201,526,27,0,152
IMG_3326.MOV,364,145,375,201,524,27,0,149
IMG_3326.MOV,365,145,375,201,524,27,0,149
IMG_3326.MOV,366,143,374,200,524,27,0,150
IMG_3326.MOV,367,143,373,199,523,27,0,150
IMG_3326.MOV,368,142,373,199,523,27,0,150
IMG_3326.MOV,369,141,372,199,524,27,0,152
IMG_3326.MOV,370,141,374,198,525,27,0,151
IMG_3326.MOV,371,140,375,198,525,27,0,150
IMG_3326.MOV,372,140,377,197,525,27,0,148
IMG_3326.MOV,373,140,377,197,525,27,0,148
IMG_3326.MOV,374,140,378,197,525,27,0,147
IMG_3326.MOV,375,139,378,197,525,27,0,147
IMG_3326.MOV,376,138,378,196,527,27,0,149
IMG_3326.MOV,377,138,379,196,525,27,0,146
IMG_3326.MOV,378,137,381,195,523,27,0,142
IMG_3326.MOV,379,136,383,193,521,27,0,138
IMG_3326.MOV,380,135,382,192,523,27,0,141
IMG_3326.MOV,381,133,379,193,526,27,0,147
IMG_3326.MOV,382,132,378,195,529,27,0,151
IMG_3326.MOV,383,132,376,195,530,27,0,154
IMG_3326.MOV,384,131,373,195,528,27,0,155
IMG_3326.MOV,385,130,372,193,527,27,0,155
IMG_3326.MOV,386,129,374,191,527,27,0,153
IMG_3326.MOV,387,128,371,190,527,27,0,156
IMG_3326.MOV,388,129,371,191,527,27,0,156
IMG_3326.MOV,389,129,370,191,530,27,0,160
IMG_3326.MOV,390,129,370,190,530,27,0,160
IMG_3326.MOV,391,129,369,190,532,27,0,163
IMG_3326.MOV,392,129,369,189,532,27,0,163
IMG_3326.MOV,393,129,366,188,532,27,0,166
IMG_3326.MOV,394,128,366,188,532,27,1,166
IMG_3326.MOV,416,101,362,161,538,27,0,176
IMG_3326.MOV,417,101,366,156,530,27,0,164
IMG_3326.MOV,418,100,366,154,529,27,1,163
IMG_3326.MOV,419,100,366,151,521,27,0,155
IMG_3326.MOV,420,100,366,150,519,27,0,153
IMG_3326.MOV,421,98,366,149,522,27,0,156
IMG_3326.MOV,422,98,369,147,519,27,0,150
IMG_3326.MOV,423,98,369,145,514,27,0,145
IMG_3326.MOV,424,98,368,144,512,27,0,144
IMG_3326.MOV,425,98,366,145,511,27,0,145
IMG_3326.MOV,426,97,364,146,512,27,0,148
IMG_3326.MOV,427,97,363,147,513,27,0,150
IMG_3326.MOV,428,97,361,147,514,27,0,153
IMG_3326.MOV,429,96,361,147,515,27,0,154
IMG_3326.MOV,430,96,360,148,516,27,0,156
IMG_3326.MOV,431,96,360,148,516,27,0,156
IMG_3326.MOV,432,96,359,149,517,27,0,158
IMG_3326.MOV,433,95,358,150,518,27,0,160
IMG_3326.MOV,434,95,359,150,518,27,0,159
IMG_3326.MOV,435,95,362,149,516,27,0,154
IMG_3326.MOV,436,96,366,148,515,27,0,149
IMG_3326.MOV,437,96,367,149,515,27,0,148
IMG_3326.MOV,438,96,366,150,514,27,0,148
IMG_3326.MOV,439,95,366,150,515,27,0,149
IMG_3326.MOV,440,94,366,151,515,27,0,149
IMG_3326.MOV,441,94,368,150,513,27,0,145
IMG_3326.MOV,442,92,367,150,515,27,0,148
IMG_3326.MOV,443,91,367,151,518,27,0,151
IMG_3326.MOV,444,90,367,151,518,27,0,151
IMG_3326.MOV,445,89,366,151,519,27,0,153
IMG_3326.MOV,446,87,365,151,519,27,0,154
IMG_3326.MOV,447,86,363,152,519,27,0,156
IMG_3326.MOV,448,86,362,152,520,27,0,158
IMG_3326.MOV,449,85,360,153,520,27,0,160
IMG_3326.MOV,450,84,360,153,522,27,0,162
IMG_3326.MOV,451,83,359,152,523,27,0,164
IMG_3326.MOV,452,82,359,152,523,27,0,164
IMG_3326.MOV,453,83,358,153,522,27,0,164
IMG_3326.MOV,454,74,363,140,520,27,0,157
IMG_3326.MOV,455,71,365,135,518,27,0,153
IMG_3326.MOV,456,70,367,132,516,27,0,149
IMG_3326.MOV,457,69,367,130,514,27,0,147
IMG_3326.MOV,458,69,368,130,514,27,0,146
IMG_3326.MOV,459,69,368,129,514,27,0,146
IMG_3326.MOV,460,70,368,130,515,27,0,147
IMG_3326.MOV,461,69,366,131,517,27,0,151
IMG_3326.MOV,462,68,367,130,518,27,0,151
IMG_3326.MOV,463,68,367,130,518,27,0,151
IMG_3326.MOV,464,67,366,129,519,27,0,153
IMG_3326.MOV,465,68,366,129,519,27,0,153
IMG_3326.MOV,466,68,367,129,519,27,0,152
IMG_3326.MOV,467,68,368,129,519,27,0,151
IMG_3326.MOV,468,68,367,129,520,27,0,153
IMG_3326.MOV,469,68,366,129,520,27,0,154
IMG_3326.MOV,470,68,366,129,520,27,0,154
IMG_3326.MOV,471,68,364,130,518,27,0,154
IMG_3326.MOV,472,68,363,130,518,27,0,155
IMG_3326.MOV,473,68,363,130,518,27,0,155
IMG_3326.MOV,474,69,362,131,518,27,0,156
IMG_3326.MOV,475,68,361,130,517,27,0,156
IMG_3326.MOV,476,68,361,130,517,27,0,156
IMG_3326.MOV,477,68,361,130,517,27,0,156
IMG_3326.MOV,478,67,360,130,517,27,0,157
IMG_3326.MOV,479,67,360,130,517,27,0,157
IMG_3326.MOV,480,66,359,129,516,27,0,157
IMG_3326.MOV,481,65,358,129,516,27,0,158
IMG_3326.MOV,482,65,359,128,514,27,0,155
IMG_3326.MOV,483,65,360,127,513,27,0,153
IMG_3326.MOV,484,64,360,127,512,27,0,152
IMG_3326.MOV,485,64,361,126,513,27,0,152
IMG_3326.MOV,486,63,361,126,513,27,0,152
IMG_3326.MOV,487,63,361,125,513,27,0,152
IMG_3326.MOV,488,62,361,124,513,27,0,152
IMG_3326.MOV,489,62,362,124,512,27,0,150
IMG_3326.MOV,490,62,362,124,511,27,0,149
IMG_3326.MOV,491,61,362,123,511,27,0,149
IMG_3326.MOV,492,60,361,123,511,27,0,150
IMG_3326.MOV,493,58,361,122,511,27,0,150
IMG_3326.MOV,494,58,363,121,511,27,0,148
IMG_3326.MOV,495,56,363,120,511,27,0,148
IMG_3326.MOV,496,56,363,119,510,27,0,147
IMG_3326.MOV,497,56,362,120,510,27,0,148
IMG_3326.MOV,498,54,362,119,510,27,0,148
IMG_3326.MOV,499,53,362,118,510,27,0,148
IMG_3326.MOV,500,51,362,117,510,27,0,148
IMG_3326.MOV,501,50,362,116,512,27,0,150
IMG_3326.MOV,502,49,362,115,511,27,0,149
IMG_3326.MOV,503,48,362,115,511,27,0,149
IMG_3326.MOV,504,47,362,114,511,27,0,149
IMG_3326.MOV,505,47,361,114,511,27,0,150
IMG_3326.MOV,506,46,361,113,513,27,0,152
IMG_3326.MOV,507,46,361,114,513,27,0,152
IMG_3326.MOV,508,45,361,113,513,27,0,152
IMG_3326.MOV,509,45,360,113,513,27,0,153
IMG_3326.MOV,510,45,360,113,513,27,0,153
IMG_3326.MOV,511,44,359,113,514,27,0,155
IMG_3326.MOV,512,37,361,103,511,27,0,150
IMG_3326.MOV,513,34,362,98,509,27,0,147
IMG_3326.MOV,514,34,365,95,504,27,0,139
IMG_3326.MOV,515,34,366,93,502,27,0,136
IMG_3326.MOV,516,35,366,93,501,27,0,135
IMG_3326.MOV,517,34,364,94,504,27,0,140
IMG_3326.MOV,518,33,363,94,506,27,0,143
IMG_3326.MOV,519,32,362,94,510,27,0,148
IMG_3326.MOV,520,32,362,94,512,27,0,150
IMG_3326.MOV,521,32,362,94,514,27,0,152
IMG_3326.MOV,522,32,361,95,515,27,0,154
IMG_3326.MOV,523,33,361,94,514,27,0,153
IMG_3326.MOV,524,33,361,94,514,27,0,153
IMG_3326.MOV,525,33,362,94,514,27,0,152
IMG_3326.MOV,526,33,362,93,513,27,0,151
IMG_3326.MOV,527,34,363,93,513,27,0,150
IMG_3326.MOV,528,34,362,94,513,27,0,151
IMG_3326.MOV,529,33,362,93,513,27,0,151
IMG_3326.MOV,530,33,362,93,514,27,0,152
IMG_3326.MOV,531,33,361,93,514,27,0,153
IMG_3326.MOV,532,33,363,92,512,27,0,149
IMG_3326.MOV,533,33,363,91,510,27,0,147
IMG_3326.MOV,534,33,363,91,510,27,0,147
IMG_3326.MOV,535,33,362,92,510,27,0,148
IMG_3326.MOV,536,32,360,91,510,27,0,150
IMG_3326.MOV,537,31,360,91,511,27,0,151
IMG_3326.MOV,538,30,359,91,513,27,0,154
IMG_3326.MOV,539,30,359,91,513,27,0,154
IMG_3326.MOV,540,31,358,92,513,27,0,155
IMG_3326.MOV,541,30,358,92,513,27,0,155
IMG_3326.MOV,542,30,358,92,513,27,0,155
IMG_3326.MOV,543,29,357,91,513,27,0,156
IMG_3326.MOV,544,29,358,90,512,27,0,154
IMG_3326.MOV,545,28,358,90,512,27,0,154
IMG_3326.MOV,546,28,357,90,514,27,0,157
IMG_3326.MOV,547,27,357,90,514,27,0,157
IMG_3326.MOV,548,27,357,90,513,27,0,156
IMG_3326.MOV,549,29,359,90,510,27,0,151
IMG_3326.MOV,550,28,359,89,510,27,0,151
IMG_3326.MOV,551,27,358,89,510,27,0,152
IMG_3326.MOV,552,26,358,88,511,27,0,153
IMG_3326.MOV,553,25,357,88,511,27,0,154
IMG_3326.MOV,554,25,357,88,511,27,0,154
IMG_3326.MOV,555,25,357,88,510,27,0,153
IMG_3326.MOV,556,25,358,88,510,27,0,152
IMG_3326.MOV,557,25,358,87,509,27,0,151
IMG_3326.MOV,558,24,358,87,510,27,0,152
IMG_3326.MOV,559,22,358,86,510,27,0,152
IMG_3326.MOV,560,21,358,85,510,27,0,152
IMG_3326.MOV,561,21,357,85,512,27,0,155
IMG_3326.MOV,562,21,358,85,512,27,0,154
IMG_3326.MOV,563,22,359,84,509,27,0,150
IMG_3326.MOV,564,25,361,85,506,27,0,145
IMG_3326.MOV,565,26,362,84,505,27,0,143
IMG_3326.MOV,566,28,363,84,504,27,0,141
IMG_3326.MOV,567,28,364,84,503,27,0,139
IMG_3326.MOV,568,28,359,81,493,27,0,134
IMG_3326.MOV,569,29,363,82,498,27,0,135
IMG_3326.MOV,570,28,359,79,491,27,0,132
IMG_3326.MOV,571,27,358,77,487,27,0,129
IMG_3326.MOV,572,25,355,77,488,27,0,133
IMG_3326.MOV,573,24,353,76,488,27,0,135
IMG_3326.MOV,574,23,352,75,488,27,0,136
IMG_3326.MOV,575,24,352,75,484,27,0,132
IMG_3326.MOV,576,22,352,74,485,27,0,133
IMG_3326.MOV,577,22,351,74,485,27,0,134
IMG_3326.MOV,578,22,350,73,486,27,0,136
IMG_3326.MOV,579,21,349,73,487,27,0,138
IMG_3326.MOV,580,21,348,73,488,27,0,140
IMG_3326.MOV,581,20,349,72,486,27,0,137
IMG_3326.MOV,582,21,351,71,484,27,0,133
IMG_3326.MOV,583,21,353,69,481,27,0,128
IMG_3326.MOV,584,21,353,69,479,27,0,126
IMG_3326.MOV,585,21,353,69,480,27,0,127
IMG_3326.MOV,586,20,351,70,483,27,0,132
IMG_3326.MOV,587,20,351,69,485,27,0,134
IMG_3326.MOV,588,20,351,69,485,27,0,134
IMG_3326.MOV,589,20,352,69,486,27,0,134
IMG_3326.MOV,590,19,352,69,486,27,0,134
IMG_3326.MOV,591,19,352,69,488,27,0,136
IMG_3326.MOV,592,19,352,69,489,27,0,137
IMG_3326.MOV,593,18,352,68,489,27,0,137
IMG_3326.MOV,594,18,351,68,490,27,1,139
IMG_3326.MOV,596,19,354,67,485,27,0,131
IMG_3326.MOV,597,18,354,66,484,27,0,130
IMG_3326.MOV,598,18,355,66,483,27,1,128
IMG_3326.MOV,600,2,361,55,506,27,0,145
IMG_3326.MOV,601,0,362,53,509,27,0,147
IMG_3326.MOV,602,0,363,53,510,27,0,147
IMG_3326.MOV,603,0,363,53,510,27,0,147
IMG_3326.MOV,604,0,363,53,510,27,0,147
IMG_3326.MOV,605,0,364,53,510,27,0,146
IMG_3326.MOV,606,0,363,54,511,27,0,148
IMG_3326.MOV,607,0,363,54,512,27,0,149
IMG_3326.MOV,613,0,370,49,508,27,0,138
IMG_3326.MOV,614,0,370,49,506,27,0,136
IMG_3326.MOV,615,0,370,49,506,27,0,136
IMG_3326.MOV,616,0,371,48,503,27,0,132
IMG_3326.MOV,617,0,374,47,501,27,0,127
IMG_3326.MOV,618,0,374,46,500,27,0,126
IMG_3326.MOV,619,0,375,45,500,27,0,125
IMG_3326.MOV,620,0,376,44,500,27,0,124
IMG_3326.MOV,621,0,377,43,499,27,1,122
IMG_3326.MOV,389,186,379,243,528,29,0,149
IMG_3326.MOV,390,186,378,242,527,29,0,149
IMG_3326.MOV,391,186,378,242,527,29,1,149
IMG_3326.MOV,420,177,380,231,522,29,0,142
IMG_3326.MOV,421,177,381,230,521,29,1,140
IMG_3326.MOV,403,256,371,317,527,31,0,156
IMG_3326.MOV,404,256,371,317,527,31,0,156
IMG_3326.MOV,405,256,371,317,527,31,0,156
IMG_3326.MOV,406,256,371,316,526,31,0,155
IMG_3326.MOV,407,254,373,315,527,31,0,154
IMG_3326.MOV,408,254,373,314,527,31,0,154
IMG_3326.MOV,409,253,374,313,527,31,0,153
IMG_3326.MOV,410,251,374,311,528,31,0,154
IMG_3326.MOV,411,250,373,309,529,31,0,156
IMG_3326.MOV,412,249,372,308,529,31,0,157
IMG_3326.MOV,413,247,372,307,531,31,0,159
IMG_3326.MOV,414,246,372,305,531,31,0,159
IMG_3326.MOV,415,245,371,305,533,31,0,162
IMG_3326.MOV,416,245,371,305,534,31,0,163
IMG_3326.MOV,417,243,371,303,534,31,0,163
IMG_3326.MOV,418,243,370,303,533,31,0,163
IMG_3326.MOV,419,243,370,301,532,31,0,162
IMG_3326.MOV,420,243,370,300,531,31,0,161
IMG_3326.MOV,421,242,370,299,530,31,0,160
IMG_3326.MOV,422,242,370,298,527,31,0,157
IMG_3326.MOV,423,241,370,297,525,31,0,155
IMG_3326.MOV,424,241,370,296,524,31,0,154
IMG_3326.MOV,425,240,370,296,524,31,0,154
IMG_3326.MOV,426,239,370,295,525,31,0,155
IMG_3326.MOV,427,237,370,295,526,31,0,156
IMG_3326.MOV,428,237,371,295,526,31,0,155
IMG_3326.MOV,429,236,371,294,525,31,0,154
IMG_3326.MOV,430,236,371,293,526,31,0,155
IMG_3326.MOV,431,235,370,293,527,31,0,157
IMG_3326.MOV,432,235,370,293,527,31,0,157
IMG_3326.MOV,433,235,369,293,527,31,0,158
IMG_3326.MOV,434,234,369,292,526,31,0,157
IMG_3326.MOV,435,234,369,292,527,31,0,158
IMG_3326.MOV,436,234,369,292,527,31,0,158
IMG_3326.MOV,437,233,369,291,527,31,0,158
IMG_3326.MOV,438,234,370,290,525,31,0,155
IMG_3326.MOV,439,234,370,290,525,31,0,155
IMG_3326.MOV,440,227,368,283,524,31,0,156
IMG_3326.MOV,441,224,367,279,523,31,0,156
IMG_3326.MOV,442,222,366,277,521,31,0,155
IMG_3326.MOV,443,222,367,275,518,31,0,151
IMG_3326.MOV,444,223,368,273,513,31,0,145
IMG_3326.MOV,445,222,366,273,513,31,0,147
IMG_3326.MOV,446,222,364,273,513,31,0,149
IMG_3326.MOV,447,222,364,273,514,31,0,150
IMG_3326.MOV,448,221,364,273,515,31,0,151
IMG_3326.MOV,449,221,365,272,514,31,0,149
IMG_3326.MOV,450,221,365,272,513,31,0,148
IMG_3326.MOV,451,220,365,271,513,31,0,148
IMG_3326.MOV,452,219,365,271,514,31,0,149
IMG_3326.MOV,453,218,365,271,516,31,0,151
IMG_3326.MOV,454,217,365,270,516,31,0,151
IMG_3326.MOV,455,217,364,269,515,31,0,151
IMG_3326.MOV,456,216,364,269,516,31,0,152
IMG_3326.MOV,457,216,364,269,516,31,0,152
IMG_3326.MOV,458,215,365,268,516,31,0,151
IMG_3326.MOV,459,215,366,267,516,31,0,150
IMG_3326.MOV,460,214,366,267,518,31,0,152
IMG_3326.MOV,461,213,366,266,519,31,0,153
IMG_3326.MOV,462,212,366,266,521,31,0,155
IMG_3326.MOV,463,212,366,266,521,31,0,155
IMG_3326.MOV,464,212,367,264,521,31,0,154
IMG_3326.MOV,465,211,367,264,521,31,0,154
IMG_3326.MOV,466,210,369,262,521,31,0,152
IMG_3326.MOV,467,210,370,261,521,31,0,151
IMG_3326.MOV,468,209,370,260,520,31,0,150
IMG_3326.MOV,469,209,371,260,520,31,0,149
IMG_3326.MOV,470,207,371,258,521,31,0,150
IMG_3326.MOV,471,206,371,257,523,31,0,152
IMG_3326.MOV,472,205,371,257,523,31,0,152
IMG_3326.MOV,473,204,371,256,523,31,0,152
IMG_3326.MOV,474,202,370,255,524,31,0,154
IMG_3326.MOV,475,202,369,255,524,31,0,155
IMG_3326.MOV,476,201,368,255,526,31,0,158
IMG_3326.MOV,477,200,368,254,527,31,0,159
IMG_3326.MOV,478,200,368,254,527,31,0,159
IMG_3326.MOV,479,199,368,254,527,31,0,159
IMG_3326.MOV,480,199,369,253,526,31,0,157
IMG_3326.MOV,481,198,370,252,526,31,0,156
IMG_3326.MOV,482,191,370,246,531,31,0,161
IMG_3326.MOV,483,187,369,243,533,31,0,164
IMG_3326.MOV,484,186,369,242,534,31,0,165
IMG_3326.MOV,485,184,368,241,536,31,0,168
IMG_3326.MOV,486,185,368,240,535,31,0,167
IMG_3326.MOV,487,184,367,239,534,31,0,167
IMG_3326.MOV,488,184,367,238,531,31,0,164
IMG_3326.MOV,489,183,367,237,534,31,0,167
IMG_3326.MOV,490,183,367,237,535,31,0,168
IMG_3326.MOV,491,183,367,237,538,31,0,171
IMG_3326.MOV,492,182,367,237,543,31,0,176
IMG_3326.MOV,493,181,367,236,545,31,0,178
IMG_3326.MOV,494,180,366,236,546,31,1,180
IMG_3326.MOV,499,178,366,233,543,31,0,177
IMG_3326.MOV,500,177,366,232,544,31,1,178
IMG_3326.MOV,404,1686,610,1792,973,32,0,363
IMG_3326.MOV,405,1686,603,1800,992,32,0,389
IMG_3326.MOV,406,1686,601,1798,979,32,0,378
IMG_3326.MOV,407,1684,595,1798,977,32,0,382
IMG_3326.MOV,408,1682,595,1798,978,32,0,383
IMG_3326.MOV,409,1682,598,1796,968,32,0,370
IMG_3326.MOV,410,1683,605,1794,957,32,0,352
IMG_3326.MOV,411,1681,607,1795,961,32,0,354
IMG_3326.MOV,412,1682,606,1798,952,32,0,346
IMG_3326.MOV,413,1684,605,1801,948,32,0,343
IMG_3326.MOV,414,1686,605,1805,947,32,0,342
IMG_3326.MOV,415,1688,606,1807,942,32,0,336
IMG_3326.MOV,416,1690,613,1808,939,32,0,326
IMG_3326.MOV,417,1690,614,1810,940,32,0,326
IMG_3326.MOV,418,1691,617,1812,945,32,0,328
IMG_3326.MOV,419,1693,629,1814,951,32,0,322
IMG_3326.MOV,420,1695,641,1813,953,32,0,312
IMG_3326.MOV,421,1696,651,1813,952,32,0,301
IMG_3326.MOV,422,1696,654,1813,953,32,0,299
IMG_3326.MOV,423,1696,652,1816,955,32,0,303
IMG_3326.MOV,424,1696,646,1821,957,32,0,311
IMG_3326.MOV,425,1695,636,1825,955,32,0,319
IMG_3326.MOV,426,1695,634,1828,958,32,0,324
IMG_3326.MOV,427,1693,626,1832,964,32,0,338
IMG_3326.MOV,428,1690,608,1837,966,32,0,358
IMG_3326.MOV,429,1689,619,1835,975,32,0,356
IMG_3326.MOV,430,1701,608,1857,987,32,0,379
IMG_3326.MOV,431,1703,596,1864,988,32,0,392
IMG_3326.MOV,432,1704,593,1866,987,32,0,394
IMG_3326.MOV,433,1704,588,1868,987,32,0,399
IMG_3326.MOV,434,1702,576,1873,993,32,0,417
IMG_3326.MOV,435,1701,571,1876,999,32,0,428
IMG_3326.MOV,436,1700,569,1876,1001,32,0,432
IMG_3326.MOV,437,1682,584,1856,1005,32,0,421
IMG_3326.MOV,438,1673,592,1849,1008,32,0,416
IMG_3326.MOV,439,1691,594,1863,1001,32,0,407
IMG_3326.MOV,440,1697,591,1870,999,32,0,408
IMG_3326.MOV,441,1699,583,1874,999,32,0,416
IMG_3326.MOV,442,1700,579,1878,1001,32,0,422
IMG_3326.MOV,443,1704,590,1878,1004,32,0,414
IMG_3326.MOV,444,1708,600,1877,1003,32,0,403
IMG_3326.MOV,445,1714,606,1880,1002,32,0,396
IMG_3326.MOV,446,1720,611,1883,1003,32,0,392
IMG_3326.MOV,447,1723,609,1887,1005,32,0,396
IMG_3326.MOV,448,1727,616,1886,1004,32,0,388
IMG_3326.MOV,449,1730,612,1891,1005,32,0,393
IMG_3326.MOV,450,1731,610,1889,997,32,0,387
IMG_3326.MOV,451,1732,605,1890,990,32,0,385
IMG_3326.MOV,452,1735,600,1891,984,32,0,384
IMG_3326.MOV,453,1735,594,1892,981,32,0,387
IMG_3326.MOV,454,1735,589,1894,984,32,0,395
IMG_3326.MOV,455,1735,587,1896,989,32,0,402
IMG_3326.MOV,456,1736,585,1897,989,32,0,404
IMG_3326.MOV,457,1737,585,1896,988,32,0,403
IMG_3326.MOV,458,1738,585,1896,987,32,0,402
IMG_3326.MOV,459,1738,584,1897,991,32,0,407
IMG_3326.MOV,460,1738,585,1898,997,32,0,412
IMG_3326.MOV,461,1740,587,1898,998,32,0,411
IMG_3326.MOV,462,1742,593,1897,1000,32,0,407
IMG_3326.MOV,463,1744,595,1897,1004,32,0,409
IMG_3326.MOV,464,1744,596,1899,1011,32,0,415
IMG_3326.MOV,465,1746,596,1901,1015,32,0,419
IMG_3326.MOV,466,1748,594,1903,1016,32,0,422
IMG_3326.MOV,467,1750,594,1904,1016,32,0,422
IMG_3326.MOV,468,1750,595,1903,1016,32,0,421
IMG_3326.MOV,469,1752,596,1902,1014,32,0,418
IMG_3326.MOV,470,1754,596,1903,1015,32,0,419
IMG_3326.MOV,471,1755,599,1902,1014,32,0,415
IMG_3326.MOV,472,1757,599,1902,1013,32,0,414
IMG_3326.MOV,473,1758,600,1902,1013,32,0,413
IMG_3326.MOV,474,1760,601,1903,1014,32,0,413
IMG_3326.MOV,475,1761,602,1903,1013,32,0,411
IMG_3326.MOV,476,1762,602,1903,1013,32,0,411
IMG_3326.MOV,477,1763,602,1902,1012,32,0,410
IMG_3326.MOV,478,1762,601,1902,1013,32,0,412
IMG_3326.MOV,479,1763,601,1903,1013,32,0,412
IMG_3326.MOV,480,1763,599,1904,1014,32,0,415
IMG_3326.MOV,481,1763,598,1904,1013,32,0,415
IMG_3326.MOV,482,1763,598,1905,1013,32,0,415
IMG_3326.MOV,483,1762,598,1905,1016,32,0,418
IMG_3326.MOV,484,1760,596,1905,1016,32,0,420
IMG_3326.MOV,485,1759,595,1905,1016,32,0,421
IMG_3326.MOV,486,1758,596,1906,1017,32,0,421
IMG_3326.MOV,487,1758,595,1907,1019,32,0,424
IMG_3326.MOV,488,1759,597,1908,1020,32,0,423
IMG_3326.MOV,489,1758,598,1908,1020,32,0,422
IMG_3326.MOV,490,1756,598,1906,1020,32,0,422
IMG_3326.MOV,491,1755,598,1907,1019,32,0,421
IMG_3326.MOV,492,1755,597,1908,1018,32,0,421
IMG_3326.MOV,493,1755,596,1908,1016,32,0,420
IMG_3326.MOV,494,1755,598,1908,1015,32,0,417
IMG_3326.MOV,495,1753,596,1908,1015,32,0,419
IMG_3326.MOV,496,1752,598,1908,1015,32,0,417
IMG_3326.MOV,497,1752,599,1908,1015,32,0,416
IMG_3326.MOV,498,1750,599,1908,1016,32,0,417
IMG_3326.MOV,499,1750,598,1909,1015,32,0,417
IMG_3326.MOV,500,1750,600,1909,1013,32,0,413
IMG_3326.MOV,501,1750,603,1908,1011,32,0,408
IMG_3326.MOV,502,1751,604,1909,1009,32,0,405
IMG_3326.MOV,503,1751,607,1908,1009,32,0,402
IMG_3326.MOV,504,1750,607,1908,1009,32,0,402
IMG_3326.MOV,505,1746,596,1915,1028,32,0,432
IMG_3326.MOV,506,1743,591,1918,1037,32,0,446
IMG_3326.MOV,507,1743,590,1918,1041,32,0,451
IMG_3326.MOV,508,1741,589,1918,1044,32,0,455
IMG_3326.MOV,509,1740,587,1918,1047,32,0,460
IMG_3326.MOV,510,1739,586,1917,1048,32,0,462
IMG_3326.MOV,511,1739,587,1915,1046,32,0,459
IMG_3326.MOV,512,1740,591,1913,1043,32,0,452
IMG_3326.MOV,513,1743,612,1903,1024,32,0,412
IMG_3326.MOV,514,1745,622,1899,1016,32,0,394
IMG_3326.MOV,515,1745,627,1898,1014,32,0,387
IMG_3326.MOV,516,1745,628,1898,1011,32,0,383
IMG_3326.MOV,517,1744,627,1898,1005,32,0,378
IMG_3326.MOV,518,1743,626,1899,1006,32,0,380
IMG_3326.MOV,519,1742,624,1900,1004,32,0,380
IMG_3326.MOV,520,1741,623,1901,1006,32,0,383
IMG_3326.MOV,521,1740,620,1903,1010,32,0,390
IMG_3326.MOV,522,1740,620,1904,1011,32,0,391
IMG_3326.MOV,523,1741,620,1906,1013,32,0,393
IMG_3326.MOV,524,1740,618,1907,1017,32,0,399
IMG_3326.MOV,525,1738,615,1909,1021,32,0,406
IMG_3326.MOV,526,1734,605,1913,1034,32,0,429
IMG_3326.MOV,527,1733,600,1914,1038,32,0,438
IMG_3326.MOV,528,1734,600,1913,1038,32,0,438
IMG_3326.MOV,529,1733,599,1914,1040,32,0,441
IMG_3326.MOV,530,1734,598,1915,1042,32,0,444
IMG_3326.MOV,531,1733,597,1916,1046,32,0,449
IMG_3326.MOV,532,1733,593,1917,1051,32,0,458
IMG_3326.MOV,533,1732,592,1918,1055,32,0,463
IMG_3326.MOV,534,1732,592,1919,1057,32,0,465
IMG_3326.MOV,535,1736,600,1915,1047,32,0,447
IMG_3326.MOV,536,1738,604,1914,1042,32,0,438
IMG_3326.MOV,537,1738,604,1915,1042,32,0,438
IMG_3326.MOV,538,1734,591,1921,1057,32,0,466
IMG_3326.MOV,539,1737,598,1917,1046,32,0,448
IMG_3326.MOV,540,1733,587,1921,1060,32,0,473
IMG_3326.MOV,541,1732,586,1922,1064,32,0,478
IMG_3326.MOV,542,1733,588,1920,1064,32,0,476
IMG_3326.MOV,543,1734,590,1919,1062,32,0,472
IMG_3326.MOV,544,1736,593,1919,1060,32,0,467
IMG_3326.MOV,545,1738,611,1916,1067,32,0,456
IMG_3326.MOV,546,1741,620,1916,1069,32,0,449
IMG_3326.MOV,547,1743,626,1916,1066,32,0,440
IMG_3326.MOV,548,1744,629,1916,1064,32,0,435
IMG_3326.MOV,549,1745,628,1918,1064,32,0,436
IMG_3326.MOV,550,1745,628,1918,1064,32,0,436
IMG_3326.MOV,551,1744,626,1920,1065,32,0,439
IMG_3326.MOV,552,1744,625,1921,1066,32,0,441
IMG_3326.MOV,553,1744,622,1924,1068,32,0,446
IMG_3326.MOV,554,1745,623,1924,1067,32,0,444
IMG_3326.MOV,555,1745,623,1925,1067,32,0,444
IMG_3326.MOV,556,1745,622,1926,1068,32,0,446
IMG_3326.MOV,557,1745,621,1926,1068,32,0,447
IMG_3326.MOV,558,1745,622,1926,1069,32,0,447
IMG_3326.MOV,559,1746,621,1928,1071,32,0,450
IMG_3326.MOV,560,1746,622,1928,1072,32,0,450
IMG_3326.MOV,561,1747,623,1928,1071,32,0,448
IMG_3326.MOV,562,1748,626,1927,1069,32,0,443
IMG_3326.MOV,563,1761,629,1934,1067,32,0,438
IMG_3326.MOV,564,1767,630,1936,1066,32,0,436
IMG_3326.MOV,565,1756,626,1929,1070,32,0,444
IMG_3326.MOV,566,1763,623,1934,1071,32,0,448
IMG_3326.MOV,567,1766,622,1935,1071,32,0,449
IMG_3326.MOV,568,1768,622,1935,1070,32,0,448
IMG_3326.MOV,569,1770,624,1934,1069,32,0,445
IMG_3326.MOV,570,1772,624,1934,1070,32,0,446
IMG_3326.MOV,571,1773,624,1933,1070,32,0,446
IMG_3326.MOV,572,1774,625,1933,1070,32,0,445
IMG_3326.MOV,573,1775,624,1932,1071,32,0,447
IMG_3326.MOV,574,1776,624,1932,1072,32,0,448
IMG_3326.MOV,575,1763,619,1922,1074,32,0,455
IMG_3326.MOV,576,1770,620,1927,1075,32,0,455
IMG_3326.MOV,577,1772,618,1929,1077,32,0,459
IMG_3326.MOV,578,1773,614,1930,1081,32,0,467
IMG_3326.MOV,579,1774,613,1931,1082,32,0,469
IMG_3326.MOV,580,1777,614,1931,1082,32,0,468
IMG_3326.MOV,581,1778,615,1930,1081,32,0,466
IMG_3326.MOV,582,1779,616,1929,1080,32,0,464
IMG_3326.MOV,583,1781,617,1928,1079,32,0,462
IMG_3326.MOV,584,1781,614,1929,1083,32,0,469
IMG_3326.MOV,585,1783,614,1930,1085,32,0,471
IMG_3326.MOV,586,1783,617,1928,1084,32,0,467
IMG_3326.MOV,587,1786,621,1928,1084,32,0,463
IMG_3326.MOV,588,1786,618,1927,1085,32,0,467
IMG_3326.MOV,589,1786,617,1927,1086,32,0,469
IMG_3326.MOV,590,1786,617,1926,1085,32,0,468
IMG_3326.MOV,591,1787,618,1926,1084,32,0,466
IMG_3326.MOV,592,1790,621,1925,1081,32,0,460
IMG_3326.MOV,593,1791,624,1925,1080,32,0,456
IMG_3326.MOV,594,1792,624,1924,1079,32,0,455
IMG_3326.MOV,595,1793,625,1924,1080,32,0,455
IMG_3326.MOV,596,1794,627,1924,1080,32,0,453
IMG_3326.MOV,597,1794,628,1923,1079,32,0,451
IMG_3326.MOV,598,1796,628,1925,1081,32,0,453
IMG_3326.MOV,599,1796,642,1921,1078,32,0,436
IMG_3326.MOV,600,1795,641,1921,1078,32,0,437
IMG_3326.MOV,601,1795,641,1922,1078,32,0,437
IMG_3326.MOV,602,1795,639,1922,1078,32,0,439
IMG_3326.MOV,603,1776,592,1920,1088,32,0,496
IMG_3326.MOV,604,1769,573,1919,1091,32,0,518
IMG_3326.MOV,605,1766,566,1919,1092,32,0,526
IMG_3326.MOV,606,1765,564,1919,1093,32,0,529
IMG_3326.MOV,607,1765,563,1920,1094,32,0,531
IMG_3326.MOV,608,1765,561,1920,1094,32,0,533
IMG_3326.MOV,609,1765,559,1921,1095,32,0,536
IMG_3326.MOV,610,1774,554,1927,1087,32,0,533
IMG_3326.MOV,611,1779,551,1930,1085,32,0,534
IMG_3326.MOV,612,1780,549,1930,1083,32,0,534
IMG_3326.MOV,613,1782,548,1929,1083,32,0,535
IMG_3326.MOV,614,1784,550,1929,1083,32,0,533
IMG_3326.MOV,615,1774,559,1920,1091,32,0,532
IMG_3326.MOV,616,1780,556,1925,1086,32,0,530
IMG_3326.MOV,617,1773,562,1918,1091,32,0,529
IMG_3326.MOV,618,1781,554,1925,1086,32,0,532
IMG_3326.MOV,619,1785,551,1928,1084,32,0,533
IMG_3326.MOV,620,1775,559,1920,1092,32,0,533
IMG_3326.MOV,621,1783,556,1924,1086,32,0,530
IMG_3326.MOV,622,1784,555,1925,1085,32,0,530
IMG_3326.MOV,623,1777,561,1918,1091,32,0,530
IMG_3326.MOV,624,1774,565,1916,1094,32,0,529
IMG_3326.MOV,625,1772,565,1916,1092,32,0,527
IMG_3326.MOV,626,1771,569,1915,1091,32,0,522
IMG_3326.MOV,627,1769,562,1916,1091,32,0,529
IMG_3326.MOV,628,1768,563,1916,1089,32,0,526
IMG_3326.MOV,629,1768,567,1916,1087,32,0,520
IMG_3326.MOV,630,1768,565,1916,1088,32,0,523
IMG_3326.MOV,631,1791,621,1921,1083,32,0,462
IMG_3326.MOV,632,1801,638,1925,1082,32,0,444
IMG_3326.MOV,633,1806,647,1926,1081,32,0,434
IMG_3326.MOV,634,1807,650,1925,1080,32,0,430
IMG_3326.MOV,635,1806,642,1926,1083,32,0,441
IMG_3326.MOV,636,1781,588,1919,1090,32,0,502
IMG_3326.MOV,637,1793,613,1923,1087,32,0,474
IMG_3326.MOV,638,1797,613,1926,1089,32,0,476
IMG_3326.MOV,639,1802,619,1927,1087,32,0,468
IMG_3326.MOV,640,1804,618,1928,1087,32,0,469
IMG_3326.MOV,641,1806,619,1928,1085,32,0,466
IMG_3326.MOV,642,1806,618,1927,1085,32,0,467
IMG_3326.MOV,643,1806,617,1927,1084,32,0,467
IMG_3326.MOV,644,1806,617,1926,1084,32,0,467
IMG_3326.MOV,645,1807,617,1926,1084,32,0,467
IMG_3326.MOV,646,1808,618,1926,1084,32,0,466
IMG_3326.MOV,647,1808,621,1925,1083,32,0,462
IMG_3326.MOV,648,1810,625,1925,1083,32,0,458
IMG_3326.MOV,440,477,443,542,583,33,0,140
IMG_3326.MOV,441,477,442,542,583,33,0,141
IMG_3326.MOV,442,477,443,542,585,33,0,142
IMG_3326.MOV,443,477,443,542,586,33,0,143
IMG_3326.MOV,444,476,443,543,587,33,0,144
IMG_3326.MOV,445,476,443,543,589,33,0,146
IMG_3326.MOV,446,483,441,552,592,33,0,151
IMG_3326.MOV,447,486,440,555,593,33,0,153
IMG_3326.MOV,448,487,440,556,595,33,0,155
IMG_3326.MOV,449,487,441,557,596,33,0,155
IMG_3326.MOV,450,487,441,558,598,33,0,157
IMG_3326.MOV,451,488,441,559,600,33,1,159
IMG_3326.MOV,458,474,446,575,682,33,0,236
IMG_3326.MOV,459,474,447,574,690,33,0,243
IMG_3326.MOV,460,473,448,576,697,33,1,249
IMG_3326.MOV,459,512,566,604,768,36,0,202
IMG_3326.MOV,460,499,557,596,770,36,0,213
IMG_3326.MOV,461,497,563,592,770,36,0,207
IMG_3326.MOV,462,503,567,597,771,36,0,204
IMG_3326.MOV,463,503,571,596,772,36,0,201
IMG_3326.MOV,464,506,573,599,771,36,0,198
IMG_3326.MOV,465,504,568,602,773,36,0,205
IMG_3326.MOV,466,507,569,605,774,36,0,205
IMG_3326.MOV,467,510,567,611,777,36,0,210
IMG_3326.MOV,468,513,563,617,779,36,0,216
IMG_3326.MOV,469,516,562,622,782,36,0,220
IMG_3326.MOV,470,520,562,626,782,36,0,220
IMG_3326.MOV,471,523,560,630,782,36,0,222
IMG_3326.MOV,472,524,559,632,782,36,0,223
IMG_3326.MOV,473,527,560,634,781,36,0,221
IMG_3326.MOV,474,541,564,644,777,36,0,213
IMG_3326.MOV,475,547,564,650,779,36,0,215
IMG_3326.MOV,476,549,564,652,780,36,0,216
IMG_3326.MOV,477,550,563,653,782,36,0,219
IMG_3326.MOV,478,552,563,654,783,36,0,220
IMG_3326.MOV,479,554,564,655,782,36,0,218
IMG_3326.MOV,480,556,564,655,780,36,0,216
IMG_3326.MOV,481,556,564,653,779,36,0,215
IMG_3326.MOV,482,558,565,653,778,36,0,213
IMG_3326.MOV,483,560,567,653,778,36,0,211
IMG_3326.MOV,484,562,567,655,779,36,0,212
IMG_3326.MOV,485,564,567,658,780,36,0,213
IMG_3326.MOV,486,566,568,660,782,36,0,214
IMG_3326.MOV,487,568,571,661,782,36,0,211
IMG_3326.MOV,488,568,572,662,784,36,0,212
IMG_3326.MOV,489,569,575,661,784,36,0,209
IMG_3326.MOV,490,570,577,664,785,36,0,208
IMG_3326.MOV,491,573,584,670,794,36,0,210
IMG_3326.MOV,492,577,589,676,798,36,0,209
IMG_3326.MOV,493,584,590,684,800,36,0,210
IMG_3326.MOV,494,590,590,690,802,36,0,212
IMG_3326.MOV,495,595,592,692,800,36,0,208
IMG_3326.MOV,496,599,594,693,798,36,0,204
IMG_3326.MOV,497,604,594,696,797,36,0,203
IMG_3326.MOV,498,604,594,696,797,36,0,203
IMG_3326.MOV,499,606,594,697,800,36,0,206
IMG_3326.MOV,500,607,596,697,799,36,0,203
IMG_3326.MOV,501,609,595,698,798,36,0,203
IMG_3326.MOV,502,610,597,698,797,36,0,200
IMG_3326.MOV,503,612,597,700,797,36,0,200
IMG_3326.MOV,504,620,594,713,799,36,0,205
IMG_3326.MOV,505,623,593,719,799,36,0,206
IMG_3326.MOV,506,623,592,723,802,36,0,210
IMG_3326.MOV,507,623,593,725,803,36,0,210
IMG_3326.MOV,508,623,593,728,805,36,0,212
IMG_3326.MOV,509,622,595,728,806,36,0,211
IMG_3326.MOV,510,624,600,730,806,36,0,206
IMG_3326.MOV,511,626,605,733,805,36,0,200
IMG_3326.MOV,512,629,610,735,805,36,0,195
IMG_3326.MOV,513,632,613,739,808,36,0,195
IMG_3326.MOV,514,638,612,748,812,36,0,200
IMG_3326.MOV,515,647,616,756,813,36,0,197
IMG_3326.MOV,516,651,618,760,814,36,0,196
IMG_3326.MOV,517,663,618,773,816,36,0,198
IMG_3326.MOV,518,685,622,791,815,36,0,193
IMG_3326.MOV,519,679,620,788,820,36,0,200
IMG_3326.MOV,520,678,619,788,821,36,0,202
IMG_3326.MOV,521,689,616,801,824,36,0,208
IMG_3326.MOV,522,700,617,811,824,36,0,207
IMG_3326.MOV,523,704,618,815,828,36,0,210
IMG_3326.MOV,524,707,619,818,830,36,0,211
IMG_3326.MOV,525,708,618,819,830,36,0,212
IMG_3326.MOV,526,709,618,819,831,36,0,213
IMG_3326.MOV,527,710,620,818,832,36,0,212
IMG_3326.MOV,528,715,622,825,834,36,0,212
IMG_3326.MOV,529,714,621,825,834,36,0,213
IMG_3326.MOV,530,717,620,828,834,36,0,214
IMG_3326.MOV,531,724,623,834,834,36,0,211
IMG_3326.MOV,532,727,620,841,835,36,0,215
IMG_3326.MOV,533,728,618,845,837,36,0,219
IMG_3326.MOV,534,732,625,848,838,36,0,213
IMG_3326.MOV,535,734,628,851,840,36,0,212
IMG_3326.MOV,536,741,636,855,843,36,0,207
IMG_3326.MOV,537,745,638,859,844,36,1,206
IMG_3326.MOV,538,759,637,874,846,36,0,209
IMG_3326.MOV,539,764,639,879,848,36,1,209
IMG_3326.MOV,469,303,456,345,590,37,0,134
IMG_3326.MOV,470,303,455,345,589,37,1,134
IMG_3326.MOV,471,303,453,345,589,37,0,136
IMG_3326.MOV,472,303,452,345,588,37,1,136
IMG_3326.MOV,477,301,440,349,593,37,0,153
IMG_3326.MOV,478,301,438,350,596,37,0,158
IMG_3326.MOV,479,299,433,352,598,37,0,165
IMG_3326.MOV,480,299,431,352,600,37,0,169
IMG_3326.MOV,481,298,428,353,601,37,0,173
IMG_3326.MOV,482,298,429,353,600,37,0,171
IMG_3326.MOV,483,298,428,353,601,37,0,173
IMG_3326.MOV,484,298,429,354,602,37,0,173
IMG_3326.MOV,485,298,427,354,603,37,0,176
IMG_3326.MOV,486,305,431,362,603,37,0,172
IMG_3326.MOV,487,307,431,365,604,37,0,173
IMG_3326.MOV,488,300,429,359,603,37,0,174
IMG_3326.MOV,489,298,430,356,602,37,0,172
IMG_3326.MOV,490,297,430,355,602,37,0,172
IMG_3326.MOV,491,296,427,356,602,37,0,175
IMG_3326.MOV,492,295,425,357,605,37,0,180
IMG_3326.MOV,493,294,424,357,605,37,0,181
IMG_3326.MOV,494,302,425,365,607,37,0,182
IMG_3326.MOV,495,304,426,369,608,37,0,182
IMG_3326.MOV,496,305,425,370,608,37,0,183
IMG_3326.MOV,497,305,424,371,609,37,0,185
IMG_3326.MOV,498,305,423,373,609,37,0,186
IMG_3326.MOV,499,304,422,373,610,37,0,188
IMG_3326.MOV,500,304,422,373,610,37,0,188
IMG_3326.MOV,501,304,421,374,609,37,0,188
IMG_3326.MOV,502,303,421,374,610,37,0,189
IMG_3326.MOV,503,304,420,374,610,37,0,190
IMG_3326.MOV,504,304,420,375,609,37,0,189
IMG_3326.MOV,505,303,420,375,609,37,0,189
IMG_3326.MOV,506,303,420,375,610,37,0,190
IMG_3326.MOV,507,303,420,375,610,37,0,190
IMG_3326.MOV,508,304,420,376,610,37,0,190
IMG_3326.MOV,509,303,422,375,610,37,0,188
IMG_3326.MOV,510,303,422,375,610,37,0,188
IMG_3326.MOV,511,303,422,375,611,37,0,189
IMG_3326.MOV,512,303,422,375,610,37,0,188
IMG_3326.MOV,513,304,423,374,608,37,0,185
IMG_3326.MOV,514,304,423,375,608,37,0,185
IMG_3326.MOV,515,304,423,375,607,37,0,184
IMG_3326.MOV,516,304,423,375,607,37,0,184
IMG_3326.MOV,517,305,423,375,606,37,0,183
IMG_3326.MOV,518,304,423,375,607,37,0,184
IMG_3326.MOV,519,304,423,376,608,37,0,185
IMG_3326.MOV,520,303,423,376,608,37,0,185
IMG_3326.MOV,521,303,422,376,610,37,0,188
IMG_3326.MOV,522,303,421,377,611,37,0,190
IMG_3326.MOV,523,303,421,377,611,37,0,190
IMG_3326.MOV,524,303,420,377,611,37,0,191
IMG_3326.MOV,525,303,420,377,611,37,0,191
IMG_3326.MOV,526,303,420,378,611,37,0,191
IMG_3326.MOV,527,304,420,379,611,37,0,191
IMG_3326.MOV,528,304,421,379,611,37,0,190
IMG_3326.MOV,529,303,421,379,612,37,0,191
IMG_3326.MOV,530,304,421,381,612,37,0,191
IMG_3326.MOV,531,305,422,381,612,37,0,190
IMG_3326.MOV,532,305,422,382,613,37,0,191
IMG_3326.MOV,533,305,423,382,613,37,0,190
IMG_3326.MOV,534,305,423,383,612,37,0,189
IMG_3326.MOV,535,305,424,383,611,37,0,187
IMG_3326.MOV,536,306,425,384,611,37,0,186
IMG_3326.MOV,537,306,425,384,610,37,0,185
IMG_3326.MOV,538,307,426,384,610,37,0,184
IMG_3326.MOV,539,307,425,385,609,37,0,184
IMG_3326.MOV,540,308,425,386,609,37,0,184
IMG_3326.MOV,541,309,425,387,609,37,0,184
IMG_3326.MOV,542,309,426,386,609,37,0,183
IMG_3326.MOV,543,309,426,386,609,37,0,183
IMG_3326.MOV,544,309,427,385,609,37,0,182
IMG_3326.MOV,545,309,426,386,609,37,0,183
IMG_3326.MOV,546,310,426,386,609,37,0,183
IMG_3326.MOV,547,310,426,387,610,37,0,184
IMG_3326.MOV,548,311,426,387,610,37,0,184
IMG_3326.MOV,549,312,427,387,610,37,0,183
IMG_3326.MOV,550,313,427,388,610,37,0,183
IMG_3326.MOV,551,314,427,388,609,37,0,182
IMG_3326.MOV,552,314,427,389,609,37,0,182
IMG_3326.MOV,553,315,428,389,609,37,0,181
IMG_3326.MOV,554,315,428,390,610,37,0,182
IMG_3326.MOV,555,316,428,391,610,37,0,182
IMG_3326.MOV,556,315,428,391,610,37,0,182
IMG_3326.MOV,557,316,428,392,610,37,0,182
IMG_3326.MOV,558,317,428,393,610,37,0,182
IMG_3326.MOV,559,318,427,394,610,37,0,183
IMG_3326.MOV,560,319,427,395,610,37,0,183
IMG_3326.MOV,561,319,426,395,610,37,0,184
IMG_3326.MOV,562,320,426,396,611,37,0,185
IMG_3326.MOV,563,321,425,397,611,37,0,186
IMG_3326.MOV,564,322,426,397,611,37,0,185
IMG_3326.MOV,565,324,426,397,612,37,0,186
IMG_3326.MOV,566,325,426,398,612,37,0,186
IMG_3326.MOV,567,326,428,398,612,37,0,184
IMG_3326.MOV,568,328,430,397,611,37,0,181
IMG_3326.MOV,569,328,429,397,611,37,0,182
IMG_3326.MOV,570,328,429,396,611,37,0,182
IMG_3326.MOV,571,328,429,397,612,37,0,183
IMG_3326.MOV,572,336,426,407,614,37,0,188
IMG_3326.MOV,573,339,425,411,615,37,0,190
IMG_3326.MOV,574,340,425,412,615,37,0,190
IMG_3326.MOV,575,340,424,412,615,37,0,191
IMG_3326.MOV,576,340,424,412,617,37,0,193
IMG_3326.MOV,577,340,424,412,617,37,0,193
IMG_3326.MOV,578,340,424,412,618,37,0,194
IMG_3326.MOV,579,341,424,412,618,37,0,194
IMG_3326.MOV,580,342,423,412,617,37,0,194
IMG_3326.MOV,581,343,423,412,616,37,0,193
IMG_3326.MOV,582,343,423,412,616,37,0,193
IMG_3326.MOV,583,344,422,413,617,37,0,195
IMG_3326.MOV,584,344,422,413,617,37,0,195
IMG_3326.MOV,585,345,424,414,618,37,0,194
IMG_3326.MOV,586,347,426,414,618,37,0,192
IMG_3326.MOV,587,348,427,414,618,37,0,191
IMG_3326.MOV,588,348,427,414,618,37,0,191
IMG_3326.MOV,589,348,426,415,619,37,0,193
IMG_3326.MOV,590,349,426,415,618,37,0,192
IMG_3326.MOV,591,351,428,417,617,37,0,189
IMG_3326.MOV,592,352,428,418,617,37,0,189
IMG_3326.MOV,593,352,429,418,619,37,0,190
IMG_3326.MOV,594,353,427,419,619,37,0,192
IMG_3326.MOV,595,353,427,419,619,37,0,192
IMG_3326.MOV,596,354,429,420,618,37,0,189
IMG_3326.MOV,597,354,429,420,618,37,0,189
IMG_3326.MOV,598,354,429,420,618,37,0,189
IMG_3326.MOV,599,357,428,424,618,37,0,190
IMG_3326.MOV,600,358,428,427,618,37,0,190
IMG_3326.MOV,601,359,427,429,618,37,0,191
IMG_3326.MOV,602,359,427,431,617,37,0,190
IMG_3326.MOV,603,359,427,432,617,37,0,190
IMG_3326.MOV,604,361,427,435,615,37,0,188
IMG_3326.MOV,605,362,427,438,615,37,0,188
IMG_3326.MOV,606,363,427,440,614,37,0,187
IMG_3326.MOV,607,363,426,443,615,37,0,189
IMG_3326.MOV,608,363,427,445,615,37,0,188
IMG_3326.MOV,609,363,428,446,616,37,0,188
IMG_3326.MOV,610,363,429,446,616,37,0,187
IMG_3326.MOV,611,363,430,446,614,37,0,184
IMG_3326.MOV,612,363,431,446,615,37,0,184
IMG_3326.MOV,613,363,432,446,615,37,0,183
IMG_3326.MOV,614,364,432,446,613,37,0,181
IMG_3326.MOV,615,358,429,443,617,37,0,188
IMG_3326.MOV,616,361,432,444,616,37,0,184
IMG_3326.MOV,617,363,432,445,614,37,0,182
IMG_3326.MOV,618,363,431,447,616,37,0,185
IMG_3326.MOV,619,363,429,450,618,37,0,189
IMG_3326.MOV,620,364,429,451,620,37,0,191
IMG_3326.MOV,621,366,429,455,621,37,0,192
IMG_3326.MOV,622,367,428,457,623,37,0,195
IMG_3326.MOV,623,367,428,459,624,37,0,196
IMG_3326.MOV,624,368,428,460,624,37,0,196
IMG_3326.MOV,625,370,430,461,624,37,0,194
IMG_3326.MOV,626,371,430,462,624,37,0,194
IMG_3326.MOV,627,372,430,462,625,37,0,195
IMG_3326.MOV,628,373,431,462,626,37,0,195
IMG_3326.MOV,629,374,430,462,625,37,0,195
IMG_3326.MOV,630,376,431,463,624,37,0,193
IMG_3326.MOV,631,377,433,463,623,37,0,190
IMG_3326.MOV,632,378,434,463,622,37,0,188
IMG_3326.MOV,633,378,434,464,623,37,0,189
IMG_3326.MOV,634,380,434,466,623,37,0,189
IMG_3326.MOV,635,381,432,467,622,37,0,190
IMG_3326.MOV,636,381,432,468,622,37,0,190
IMG_3326.MOV,637,382,434,468,622,37,0,188
IMG_3326.MOV,638,385,436,470,621,37,0,185
IMG_3326.MOV,639,388,435,473,621,37,0,186
IMG_3326.MOV,640,389,437,473,620,37,0,183
IMG_3326.MOV,641,389,437,473,621,37,0,184
IMG_3326.MOV,642,390,437,474,621,37,0,184
IMG_3326.MOV,643,391,437,475,622,37,0,185
IMG_3326.MOV,644,392,435,477,622,37,0,187
IMG_3326.MOV,645,394,437,478,622,37,0,185
IMG_3326.MOV,646,406,440,487,619,37,0,179
IMG_3326.MOV,647,400,439,481,619,37,0,180
IMG_3326.MOV,648,398,438,479,620,37,0,182
IMG_3326.MOV,498,125,390,188,510,41,0,120
IMG_3326.MOV,499,124,388,188,511,41,0,123
IMG_3326.MOV,500,123,389,188,512,41,0,123
IMG_3326.MOV,501,124,389,187,512,41,0,123
IMG_3326.MOV,502,123,388,187,512,41,0,124
IMG_3326.MOV,503,123,387,187,512,41,0,125
IMG_3326.MOV,504,123,386,187,512,41,0,126
IMG_3326.MOV,505,123,386,187,510,41,0,124
IMG_3326.MOV,506,123,387,186,510,41,0,123
IMG_3326.MOV,507,124,387,186,510,41,0,123
IMG_3326.MOV,508,115,389,175,509,41,0,120
IMG_3326.MOV,509,111,386,172,511,41,0,125
IMG_3326.MOV,510,110,387,169,510,41,0,123
IMG_3326.MOV,511,110,385,168,509,41,0,124
IMG_3326.MOV,512,110,385,166,508,41,0,123
IMG_3326.MOV,513,111,384,166,507,41,0,123
IMG_3326.MOV,514,111,383,165,506,41,0,123
IMG_3326.MOV,515,111,384,164,506,41,0,122
IMG_3326.MOV,516,112,383,164,505,41,0,122
IMG_3326.MOV,517,111,382,164,505,41,1,123
IMG_3326.MOV,521,110,381,163,506,41,0,125
IMG_3326.MOV,522,110,379,163,506,41,0,127
IMG_3326.MOV,523,110,379,162,506,41,0,127
IMG_3326.MOV,524,110,379,162,506,41,0,127
IMG_3326.MOV,525,109,379,161,507,41,0,128
IMG_3326.MOV,526,108,379,161,507,41,0,128
IMG_3326.MOV,527,108,379,160,507,41,0,128
IMG_3326.MOV,528,107,379,161,508,41,0,129
IMG_3326.MOV,529,106,379,160,510,41,0,131
IMG_3326.MOV,530,106,381,160,510,41,0,129
IMG_3326.MOV,531,106,381,160,511,41,0,130
IMG_3326.MOV,532,106,381,160,511,41,0,130
IMG_3326.MOV,533,105,379,162,513,41,0,134
IMG_3326.MOV,534,105,377,162,514,41,0,137
IMG_3326.MOV,535,103,376,161,515,41,0,139
IMG_3326.MOV,536,103,375,160,512,41,0,137
IMG_3326.MOV,537,103,377,158,510,41,0,133
IMG_3326.MOV,538,103,379,156,508,41,0,129
IMG_3326.MOV,539,103,380,155,508,41,0,128
IMG_3326.MOV,540,103,379,154,507,41,0,128
IMG_3326.MOV,541,104,378,154,504,41,0,126
IMG_3326.MOV,542,104,378,153,502,41,0,124
IMG_3326.MOV,543,104,377,153,504,41,0,127
IMG_3326.MOV,544,102,377,152,506,41,0,129
IMG_3326.MOV,545,102,377,152,509,41,0,132
IMG_3326.MOV,546,102,378,151,509,41,0,131
IMG_3326.MOV,547,100,378,149,508,41,0,130
IMG_3326.MOV,548,100,376,149,508,41,0,132
IMG_3326.MOV,549,99,375,149,508,41,0,133
IMG_3326.MOV,550,99,372,149,509,41,0,137
IMG_3326.MOV,551,98,369,150,511,41,0,142
IMG_3326.MOV,552,97,369,150,512,41,0,143
IMG_3326.MOV,553,96,369,149,513,41,0,144
IMG_3326.MOV,554,95,370,147,514,41,0,144
IMG_3326.MOV,555,95,370,147,513,41,0,143
IMG_3326.MOV,556,94,371,146,512,41,0,141
IMG_3326.MOV,557,94,371,146,512,41,0,141
IMG_3326.MOV,558,94,372,145,511,41,0,139
IMG_3326.MOV,559,94,372,144,511,41,0,139
IMG_3326.MOV,560,93,372,143,511,41,0,139
IMG_3326.MOV,561,93,373,143,511,41,0,138
IMG_3326.MOV,562,92,374,142,512,41,0,138
IMG_3326.MOV,563,92,374,141,511,41,0,137
IMG_3326.MOV,564,93,375,140,509,41,0,134
IMG_3326.MOV,565,92,375,140,508,41,1,133
IMG_3326.MOV,567,92,378,138,505,41,0,127
IMG_3326.MOV,568,92,378,137,504,41,1,126
IMG_3326.MOV,583,80,385,120,500,41,0,115
IMG_3326.MOV,584,79,384,120,502,41,0,118
IMG_3326.MOV,585,78,384,119,501,41,0,117
IMG_3326.MOV,586,77,383,118,502,41,0,119
IMG_3326.MOV,587,75,383,118,501,41,0,118
IMG_3326.MOV,588,74,381,118,500,41,0,119
IMG_3326.MOV,589,74,381,117,498,41,0,117
IMG_3326.MOV,590,73,381,117,497,41,0,116
IMG_3326.MOV,591,72,381,117,496,41,0,115
IMG_3326.MOV,592,72,380,118,498,41,0,118
IMG_3326.MOV,593,71,379,117,498,41,0,119
IMG_3326.MOV,594,71,379,117,498,41,0,119
IMG_3326.MOV,595,70,378,117,499,41,0,121
IMG_3326.MOV,596,69,377,117,499,41,0,122
IMG_3326.MOV,597,68,376,116,499,41,0,123
IMG_3326.MOV,598,67,376,115,499,41,0,123
IMG_3326.MOV,599,66,376,115,500,41,0,124
IMG_3326.MOV,600,64,376,114,500,41,0,124
IMG_3326.MOV,601,64,375,113,499,41,0,124
IMG_3326.MOV,602,64,375,114,499,41,0,124
IMG_3326.MOV,603,63,374,113,499,41,1,125
IMG_3326.MOV,604,63,374,114,501,41,0,127
IMG_3326.MOV,605,62,375,113,501,41,0,126
IMG_3326.MOV,606,61,374,113,501,41,0,127
IMG_3326.MOV,607,61,374,113,501,41,1,127
IMG_3326.MOV,610,61,378,110,498,41,0,120
IMG_3326.MOV,611,59,378,109,499,41,0,121
IMG_3326.MOV,612,59,381,108,500,41,0,119
IMG_3326.MOV,613,58,380,108,500,41,0,120
IMG_3326.MOV,614,58,379,108,500,41,0,121
IMG_3326.MOV,615,58,381,106,500,41,0,119
IMG_3326.MOV,616,58,381,107,502,41,0,121
IMG_3326.MOV,617,58,381,107,502,41,0,121
IMG_3326.MOV,618,57,380,106,502,41,0,122
IMG_3326.MOV,619,57,380,105,502,41,0,122
IMG_3326.MOV,620,57,380,105,502,41,0,122
IMG_3326.MOV,621,57,380,105,501,41,0,121
IMG_3326.MOV,622,56,380,104,500,41,0,120
IMG_3326.MOV,623,55,380,103,500,41,0,120
IMG_3326.MOV,624,54,379,103,500,41,0,121
IMG_3326.MOV,625,53,377,103,499,41,0,122
IMG_3326.MOV,626,53,377,102,499,41,0,122
IMG_3326.MOV,627,54,376,103,499,41,0,123
IMG_3326.MOV,628,54,375,103,501,41,0,126
IMG_3326.MOV,629,53,375,102,499,41,0,124
IMG_3326.MOV,630,54,374,103,499,41,0,125
IMG_3326.MOV,631,54,374,103,499,41,0,125
IMG_3326.MOV,632,54,374,102,499,41,1,125
IMG_3326.MOV,637,44,378,89,494,41,0,116
IMG_3326.MOV,638,43,378,87,493,41,1,115
IMG_3326.MOV,541,145,373,186,516,42,0,143
IMG_3326.MOV,542,145,372,187,516,42,0,144
IMG_3326.MOV,543,144,371,187,519,42,0,148
IMG_3326.MOV,544,143,369,187,521,42,0,152
IMG_3326.MOV,545,143,368,187,522,42,0,154
IMG_3326.MOV,546,143,368,187,520,42,0,152
IMG_3326.MOV,547,143,367,187,519,42,0,152
IMG_3326.MOV,548,143,366,187,520,42,0,154
IMG_3326.MOV,549,143,367,186,520,42,0,153
IMG_3326.MOV,550,142,366,186,520,42,0,154
IMG_3326.MOV,551,141,365,186,520,42,0,155
IMG_3326.MOV,552,141,364,185,521,42,0,157
IMG_3326.MOV,553,141,364,185,522,42,0,158
IMG_3326.MOV,554,140,365,185,521,42,0,156
IMG_3326.MOV,555,140,365,184,521,42,0,156
IMG_3326.MOV,556,139,366,184,520,42,0,154
IMG_3326.MOV,557,139,367,183,520,42,0,153
IMG_3326.MOV,558,139,367,183,520,42,0,153
IMG_3326.MOV,559,138,367,183,520,42,0,153
IMG_3326.MOV,560,138,367,182,520,42,0,153
IMG_3326.MOV,561,138,368,182,520,42,0,152
IMG_3326.MOV,562,137,368,182,519,42,0,151
IMG_3326.MOV,563,137,369,181,519,42,0,150
IMG_3326.MOV,564,136,370,181,519,42,0,149
IMG_3326.MOV,565,135,370,180,517,42,0,147
IMG_3326.MOV,566,135,371,180,517,42,0,146
IMG_3326.MOV,567,134,369,179,514,42,0,145
IMG_3326.MOV,568,134,369,179,513,42,0,144
IMG_3326.MOV,569,135,369,180,512,42,0,143
IMG_3326.MOV,570,135,369,179,510,42,0,141
IMG_3326.MOV,571,134,369,180,511,42,0,142
IMG_3326.MOV,572,133,367,180,512,42,0,145
IMG_3326.MOV,573,132,366,179,512,42,0,146
IMG_3326.MOV,574,131,366,179,512,42,0,146
IMG_3326.MOV,575,131,365,180,513,42,0,148
IMG_3326.MOV,576,131,364,180,513,42,0,149
IMG_3326.MOV,577,131,364,181,513,42,0,149
IMG_3326.MOV,578,131,365,180,513,42,0,148
IMG_3326.MOV,579,131,365,180,512,42,0,147
IMG_3326.MOV,580,131,365,180,512,42,0,147
IMG_3326.MOV,581,130,366,179,512,42,0,146
IMG_3326.MOV,582,130,366,179,512,42,0,146
IMG_3326.MOV,583,130,366,179,514,42,0,148
IMG_3326.MOV,584,129,367,179,514,42,0,147
IMG_3326.MOV,585,129,367,179,515,42,0,148
IMG_3326.MOV,586,129,368,178,515,42,0,147
IMG_3326.MOV,587,128,369,177,515,42,0,146
IMG_3326.MOV,588,128,369,176,513,42,0,144
IMG_3326.MOV,589,128,370,176,512,42,0,142
IMG_3326.MOV,590,128,371,176,512,42,0,141
IMG_3326.MOV,591,127,372,176,512,42,0,140
IMG_3326.MOV,592,127,373,176,512,42,0,139
IMG_3326.MOV,593,119,370,169,511,42,0,141
IMG_3326.MOV,594,115,368,166,511,42,0,143
IMG_3326.MOV,595,113,368,165,512,42,0,144
IMG_3326.MOV,596,113,367,165,512,42,0,145
IMG_3326.MOV,597,112,367,165,512,42,0,145
IMG_3326.MOV,598,112,367,164,510,42,0,143
IMG_3326.MOV,599,111,367,164,509,42,0,142
IMG_3326.MOV,600,111,367,163,508,42,0,141
IMG_3326.MOV,601,110,366,163,508,42,0,142
IMG_3326.MOV,602,109,365,163,509,42,0,144
IMG_3326.MOV,603,108,365,164,511,42,0,146
IMG_3326.MOV,604,108,364,163,511,42,0,147
IMG_3326.MOV,605,106,364,162,511,42,0,147
IMG_3326.MOV,606,106,363,161,511,42,0,148
IMG_3326.MOV,607,106,362,162,511,42,0,149
IMG_3326.MOV,608,106,362,161,511,42,0,149
IMG_3326.MOV,609,106,362,161,510,42,0,148
IMG_3326.MOV,610,106,363,160,510,42,0,147
IMG_3326.MOV,611,106,363,160,510,42,0,147
IMG_3326.MOV,612,105,363,160,510,42,0,147
IMG_3326.MOV,613,105,362,160,510,42,0,148
IMG_3326.MOV,614,105,362,159,510,42,0,148
IMG_3326.MOV,615,105,363,158,511,42,0,148
IMG_3326.MOV,616,105,363,158,511,42,0,148
IMG_3326.MOV,617,105,362,158,511,42,0,149
IMG_3326.MOV,618,104,362,158,511,42,0,149
IMG_3326.MOV,619,104,363,158,512,42,0,149
IMG_3326.MOV,620,104,363,157,512,42,0,149
IMG_3326.MOV,621,103,363,157,513,42,0,150
IMG_3326.MOV,622,103,363,157,513,42,0,150
IMG_3326.MOV,623,103,362,157,513,42,0,151
IMG_3326.MOV,624,102,362,157,513,42,0,151
IMG_3326.MOV,625,101,361,156,514,42,0,153
IMG_3326.MOV,626,100,361,156,514,42,0,153
IMG_3326.MOV,627,100,360,156,512,42,0,152
IMG_3326.MOV,628,100,360,155,512,42,0,152
IMG_3326.MOV,629,100,361,155,510,42,0,149
IMG_3326.MOV,630,101,362,154,507,42,0,145
IMG_3326.MOV,631,101,362,154,507,42,0,145
IMG_3326.MOV,632,102,364,154,504,42,0,140
IMG_3326.MOV,633,101,364,153,504,42,0,140
IMG_3326.MOV,634,102,365,153,503,42,0,138
IMG_3326.MOV,635,101,364,153,504,42,0,140
IMG_3326.MOV,636,101,364,153,503,42,0,139
IMG_3326.MOV,637,101,364,153,503,42,0,139
IMG_3326.MOV,638,101,358,151,493,42,0,135
IMG_3326.MOV,639,101,357,151,489,42,0,132
IMG_3326.MOV,640,101,356,150,487,42,0,131
IMG_3326.MOV,641,101,356,149,485,42,1,129
IMG_3326.MOV,642,100,363,151,498,42,0,135
IMG_3326.MOV,643,100,364,151,498,42,1,134
IMG_3326.MOV,644,99,365,151,502,42,0,137
IMG_3326.MOV,645,98,365,152,503,42,0,138
IMG_3326.MOV,646,97,365,151,503,42,0,138
IMG_3326.MOV,647,94,363,150,506,42,0,143
IMG_3326.MOV,648,93,362,150,506,42,0,144
IMG_3326.MOV,571,905,641,985,843,43,0,202
IMG_3326.MOV,572,905,641,985,844,43,1,203
IMG_3326.MOV,596,960,641,1039,836,43,0,195
IMG_3326.MOV,597,958,640,1040,835,43,0,195
IMG_3326.MOV,598,954,640,1041,837,43,0,197
IMG_3326.MOV,599,955,639,1044,836,43,0,197
IMG_3326.MOV,600,957,640,1048,837,43,0,197
IMG_3326.MOV,601,957,642,1050,837,43,0,195
IMG_3326.MOV,602,963,644,1058,835,43,0,191
IMG_3326.MOV,603,965,643,1060,835,43,0,192
IMG_3326.MOV,604,964,644,1059,833,43,0,189
IMG_3326.MOV,605,962,641,1060,831,43,0,190
IMG_3326.MOV,606,964,641,1062,830,43,1,189
IMG_3326.MOV,607,964,645,1064,835,43,0,190
IMG_3326.MOV,608,966,646,1066,835,43,1,189
IMG_3326.MOV,611,986,640,1094,849,43,0,209
IMG_3326.MOV,612,986,630,1099,856,43,0,226
IMG_3326.MOV,613,995,630,1106,858,43,0,228
IMG_3326.MOV,614,1007,629,1112,852,43,0,223
IMG_3326.MOV,615,1014,629,1116,851,43,0,222
IMG_3326.MOV,616,1021,629,1117,843,43,0,214
IMG_3326.MOV,617,1028,632,1118,839,43,0,207
IMG_3326.MOV,618,1033,635,1122,841,43,0,206
IMG_3326.MOV,619,1037,635,1126,841,43,1,206
IMG_3326.MOV,621,1045,641,1133,846,43,0,205
IMG_3326.MOV,622,1047,639,1135,845,43,0,206
IMG_3326.MOV,623,1048,635,1139,848,43,0,213
IMG_3326.MOV,624,1048,635,1140,851,43,0,216
IMG_3326.MOV,625,1049,636,1140,849,43,0,213
IMG_3326.MOV,626,1049,635,1140,850,43,0,215
IMG_3326.MOV,627,1049,635,1139,848,43,0,213
IMG_3326.MOV,628,1051,635,1140,848,43,0,213
IMG_3326.MOV,629,1053,635,1143,848,43,1,213
IMG_3326.MOV,632,1057,575,1174,858,43,0,283
IMG_3326.MOV,633,1063,580,1176,859,43,0,279
IMG_3326.MOV,634,1067,589,1173,854,43,0,265
IMG_3326.MOV,635,1073,601,1172,851,43,0,250
IMG_3326.MOV,636,1077,604,1173,855,43,0,251
IMG_3326.MOV,637,1079,615,1173,860,43,0,245
IMG_3326.MOV,638,1078,593,1180,863,43,0,270
IMG_3326.MOV,639,1080,590,1183,864,43,1,274
IMG_3326.MOV,640,1088,626,1176,858,43,0,232
IMG_3326.MOV,641,1093,641,1175,856,43,0,215
IMG_3326.MOV,642,1092,643,1174,859,43,0,216
IMG_3326.MOV,643,1093,650,1168,846,43,0,196
IMG_3326.MOV,644,1093,652,1165,843,43,0,191
IMG_3326.MOV,645,1095,655,1164,839,43,0,184
IMG_3326.MOV,646,1097,656,1165,841,43,0,185
IMG_3326.MOV,647,1099,659,1166,839,43,0,180
IMG_3326.MOV,648,1098,665,1170,863,43,0,198
IMG_3326.MOV,624,509,465,610,696,46,0,231
IMG_3326.MOV,625,513,464,613,697,46,0,233
IMG_3326.MOV,626,517,461,618,696,46,0,235
IMG_3326.MOV,627,514,459,616,696,46,0,237
IMG_3326.MOV,628,515,459,617,695,46,0,236
IMG_3326.MOV,629,516,455,620,697,46,0,242
IMG_3326.MOV,630,516,455,619,697,46,0,242
IMG_3326.MOV,631,517,457,618,698,46,0,241
IMG_3326.MOV,632,518,459,617,698,46,0,239
IMG_3326.MOV,633,518,458,617,700,46,0,242
IMG_3326.MOV,634,520,457,619,701,46,0,244
IMG_3326.MOV,635,521,460,618,702,46,0,242
IMG_3326.MOV,636,521,464,616,705,46,0,241
IMG_3326.MOV,637,521,466,614,703,46,0,237
IMG_3326.MOV,638,521,462,615,705,46,0,243
IMG_3326.MOV,639,521,462,616,711,46,0,249
IMG_3326.MOV,640,522,463,616,713,46,0,250
IMG_3326.MOV,641,524,464,616,713,46,0,249
IMG_3326.MOV,642,525,466,615,712,46,0,246
IMG_3326.MOV,643,525,464,616,716,46,0,252
IMG_3326.MOV,644,525,460,619,722,46,0,262
IMG_3326.MOV,645,527,461,619,723,46,0,262
IMG_3326.MOV,646,528,462,620,725,46,0,263
IMG_3326.MOV,647,529,462,621,727,46,0,265
IMG_3326.MOV,648,530,463,622,730,46,0,267
